"","n_total","n_is","n_hf","mean_strike_is","mean_strike_hf"
"1",474,83,391,185.385364264094,175.406547250292
"2",499,88,411,216.196855768609,181.517967485758
"3",492,86,406,200.631150561463,176.119077004812
"4",479,88,391,185.671929481694,179.156693301317
"5",483,82,401,194.168815405618,172.303010444238
"6",483,90,393,196.528167199236,181.979249043111
"7",481,77,404,185.617412610781,169.700150210259
"8",481,86,395,193.816714216207,172.1015833359
"9",469,84,385,201.054025506779,174.49516443161
"10",475,85,390,197.230580667223,177.316002970572
"11",481,82,399,189.92216759936,175.126055957512
"12",503,92,411,188.274358373276,173.285592433221
"13",491,87,404,199.507145577372,176.338044224053
"14",490,87,403,195.045490124325,174.476820066013
"15",486,83,403,186.17428416818,175.297698903556
"16",471,84,387,188.305706927818,173.377017725762
"17",494,85,409,197.153698104673,176.429652446657
"18",490,82,408,190.330250122933,173.52798726027
"19",500,82,418,201.199055262538,182.210624693001
"20",468,82,386,197.89941744564,179.306268063435
"21",501,87,414,196.872706136194,176.85950185586
"22",480,81,399,197.038997764014,172.741496919112
"23",500,86,414,206.982923517075,180.386228358186
"24",493,84,409,188.56523015278,175.724791533732
"25",486,90,396,205.390868666842,182.334676387429
"26",468,80,388,202.642348228471,177.511664457047
"27",486,92,394,194.677964794007,178.791697225883
"28",499,88,411,193.764642188501,175.476261795534
"29",486,87,399,185.469771270707,181.502783475776
"30",481,84,397,196.956867913456,179.922095633343
"31",498,84,414,198.186637373122,176.024102068061
"32",478,83,395,200.353906644084,173.604551079487
"33",486,90,396,195.949944807838,172.411345808408
"34",480,83,397,200.828638190962,174.318400082622
"35",492,81,411,189.102514146579,179.698832663614
"36",476,77,399,198.203353615351,175.435909099558
"37",471,77,394,186.110769227709,176.139528385508
"38",486,87,399,185.450649838593,173.209138866425
"39",480,82,398,193.822833582949,178.672355480208
"40",500,86,414,199.858834567036,181.378382648372
"41",496,89,407,192.174547610768,171.537841958126
"42",503,91,412,211.484846770118,177.776853230783
"43",477,81,396,200.251232139803,178.284880058818
"44",485,90,395,192.961403572423,176.820163117338
"45",481,85,396,187.247825073794,176.862613899004
"46",481,89,392,192.839656884467,175.523509309511
"47",497,92,405,190.542572845294,179.909995877403
"48",474,79,395,187.165329069521,180.523148110241
"49",485,84,401,208.144099485635,172.921672160049
"50",481,86,395,195.314364205246,172.624673938406
"51",499,86,413,197.650115477211,175.393443240776
"52",482,83,399,196.623250791026,180.237232606475
"53",497,92,405,186.719769467749,180.546861106981
"54",469,88,381,193.948589359537,174.814691731708
"55",496,89,407,195.572976183633,177.425655799108
"56",485,91,394,190.763762205625,180.127147129442
"57",469,82,387,193.960580634926,173.233294509909
"58",486,90,396,201.914701463697,169.387314387283
"59",490,90,400,190.598951220969,178.787636559868
"60",478,90,388,201.863406396239,175.812535621434
"61",488,96,392,188.952989834806,174.193842504746
"62",493,84,409,186.180124116638,173.859943494079
"63",477,87,390,185.29534120312,175.037194176923
"64",481,84,397,186.688526373474,181.011627037101
"65",485,83,402,185.535536051221,178.580818415322
"66",480,82,398,192.826428803482,177.477234192703
"67",465,78,387,189.768055529248,176.896154308954
"68",495,92,403,193.427206520305,172.544433397052
"69",494,82,412,191.575419584749,181.793701539418
"70",469,82,387,198.896939014847,175.914621891849
"71",504,88,416,192.976170310824,176.201821147816
"72",491,81,410,202.088914119534,171.62924956362
"73",475,78,397,207.207962136604,175.598372370496
"74",472,81,391,195.815021545892,178.408308492127
"75",488,81,407,198.870871690518,174.480825897152
"76",474,75,399,200.633793633632,179.855920441376
"77",485,85,400,198.789028468156,174.031421564497
"78",478,82,396,195.619987527585,180.750140288198
"79",475,82,393,188.566772947648,176.604503518191
"80",484,81,403,188.113274775453,176.616220005716
"81",491,87,404,191.298372719127,184.901411550189
"82",490,82,408,207.111283943863,177.360709254418
"83",479,84,395,193.573586248298,177.786886638696
"84",475,85,390,204.011981120462,175.579434290843
"85",488,85,403,192.377869893127,171.210217156194
"86",474,83,391,202.907546952675,172.475267951147
"87",488,83,405,191.266675994834,180.872838558721
"88",494,91,403,188.96922935044,178.74504411439
"89",490,85,405,198.144960076631,174.232339208314
"90",496,89,407,182.722782470038,180.900719185126
"91",487,81,406,190.892301024066,178.020186886728
"92",476,79,397,193.265080698073,176.803660997396
"93",466,81,385,201.720060450469,180.276379626968
"94",489,86,403,200.031584621427,179.996734034424
"95",486,86,400,191.856475436481,184.236853629768
"96",488,85,403,191.130804399509,175.416115155164
"97",487,90,397,203.728347896754,175.993987826237
"98",476,86,390,193.212026791124,181.269044364355
"99",508,93,415,183.280974598829,179.840701823569
"100",487,90,397,189.719132535998,172.828897823204
"101",478,81,397,192.779937892145,172.220036370145
"102",482,86,396,190.417369103193,177.114365423453
"103",498,91,407,202.571058661729,180.263942454815
"104",472,87,385,203.707325304565,175.101893262604
"105",489,85,404,195.722952962331,179.109179097297
"106",493,86,407,190.028634899647,180.25039251058
"107",501,91,410,189.435571497734,171.100443764328
"108",494,92,402,191.807476566055,178.008800822096
"109",505,90,415,198.529933921684,171.055894707963
"110",494,98,396,187.664434902096,177.533685012505
"111",470,77,393,198.317082988617,177.723443253298
"112",484,89,395,206.091967076774,175.786265097969
"113",481,87,394,191.753064543584,178.066960698191
"114",495,85,410,185.510427997171,173.799426340345
"115",489,82,407,195.054457047909,175.642597092176
"116",489,87,402,194.531910460817,177.644370053987
"117",467,77,390,192.518001143962,173.513783063585
"118",485,84,401,181.979830918413,175.519315122447
"119",492,98,394,197.805538126548,177.971789688674
"120",491,89,402,188.544821282491,173.587644233904
"121",494,86,408,200.368733053593,180.433742752238
"122",467,83,384,194.023883973763,177.305805855562
"123",475,83,392,197.43110453203,176.089530247767
"124",493,100,393,186.462997619586,175.401997779606
"125",488,88,400,197.177633863066,175.215574831065
"126",487,85,402,195.162763248997,181.125883755354
"127",492,80,412,196.308090519084,168.565423780466
"128",462,83,379,194.823232619805,177.373686553688
"129",487,88,399,192.013428274801,175.307129573144
"130",484,80,404,196.892443441063,175.301455230165
"131",477,81,396,203.750439964262,178.393651582869
"132",479,82,397,194.417720672773,184.123068795974
"133",495,85,410,190.70414245022,174.948290064227
"134",480,85,395,190.35414508951,173.398994530742
"135",499,82,417,188.828500792027,174.574130431954
"136",476,83,393,199.26315705907,178.769395554768
"137",481,87,394,192.140666601391,179.962443812885
"138",490,85,405,190.371223641005,172.230809555112
"139",485,89,396,186.003123140551,180.650709208021
"140",471,80,391,196.311167245475,172.596244715227
"141",484,88,396,193.323349750103,179.704144527978
"142",497,81,416,196.939460464704,174.752818168207
"143",481,81,400,189.471306462114,175.794195099002
"144",475,89,386,203.37036864113,181.644128148776
"145",485,94,391,199.843169475872,179.545737355741
"146",487,79,408,194.797866951869,179.080244430487
"147",491,83,408,190.867085707298,172.136372302071
"148",497,93,404,196.946869761734,180.045110141136
"149",485,84,401,182.037510159104,178.361829865303
"150",478,88,390,206.786382784092,182.405580954812
"151",498,88,410,188.576729694539,175.963917182416
"152",481,81,400,205.062393877154,176.566729077322
"153",488,85,403,207.657086889651,177.231646491234
"154",486,90,396,173.382705488324,178.786922747867
"155",473,92,381,186.346030526551,172.306709165035
"156",494,90,404,194.814983319212,178.487038965442
"157",500,95,405,176.56830659836,177.333745699954
"158",483,89,394,180.076556151059,175.54468295364
"159",479,93,386,194.224335710898,178.238224112967
"160",502,89,413,198.687232548548,180.369146735315
"161",504,84,420,202.963209430717,171.530428959043
"162",487,91,396,202.457982811169,177.799981496578
"163",487,88,399,191.744461494512,168.65123688231
"164",489,88,401,197.196696561682,175.119708934616
"165",499,82,417,206.504896618747,178.076969827909
"166",501,91,410,193.453417843787,176.656532600565
"167",494,89,405,205.055726660814,179.948462219101
"168",477,80,397,200.558991167202,175.716082647075
"169",468,86,382,201.115809964772,183.682889097349
"170",485,85,400,202.981941525427,181.637942384958
"171",503,90,413,198.101570206704,177.764193077209
"172",483,86,397,191.831804185972,179.994302247177
"173",483,87,396,182.871038546927,181.860129710899
"174",491,89,402,190.585128628581,178.891291135536
"175",480,81,399,192.30984477311,179.017047721772
"176",473,86,387,186.18602886392,177.49332126341
"177",481,83,398,190.215353515723,173.240632755787
"178",489,88,401,210.200321920709,177.430395768517
"179",476,81,395,179.803453671549,175.348604775729
"180",496,90,406,184.772099838714,180.273162458613
"181",467,84,383,194.136253528946,178.555795865006
"182",485,78,407,196.851921387986,169.996312510792
"183",497,90,407,197.500278198175,174.716740699198
"184",493,91,402,193.029851926754,173.479392614739
"185",492,82,410,196.917890527465,178.019899874848
"186",498,90,408,178.82900179867,177.299014902826
"187",479,90,389,191.107217065944,175.13115880818
"188",480,85,395,191.222475484761,179.37196924446
"189",472,90,382,190.948120143635,177.355147417004
"190",485,97,388,190.369480311021,170.417928380186
"191",482,82,400,184.834113042037,178.100990356683
"192",490,86,404,188.173442699302,178.854851871067
"193",487,92,395,194.052778152035,177.824698402506
"194",492,91,401,201.19247557159,173.245923019586
"195",472,82,390,202.030880202334,173.886179174217
"196",484,82,402,202.653880798938,178.476811998121
"197",489,88,401,195.003673373962,176.254928088481
"198",479,85,394,197.832449108742,175.463079176126
"199",477,81,396,200.232614323029,178.117003348467
"200",488,87,401,186.496904948309,177.843665260057
"201",480,79,401,196.859438431541,178.422061079923
"202",481,96,385,200.098010380103,175.417386732053
"203",481,85,396,201.208127714536,175.363943326687
"204",483,86,397,184.797837615931,169.546058480298
"205",502,90,412,181.729539893468,177.208980225025
"206",473,83,390,186.268059844868,172.966184359038
"207",496,88,408,189.899141495825,175.130208048596
"208",480,82,398,191.801875852129,181.106464629658
"209",498,88,410,199.382198303879,171.804848322043
"210",478,86,392,190.306332069773,181.387712040356
"211",488,83,405,198.206110638969,175.634247702925
"212",477,89,388,192.75684331099,181.323960647141
"213",463,87,376,201.046802072165,180.627843910395
"214",502,91,411,185.940392278418,175.555183032482
"215",490,86,404,199.651472632964,174.949074672599
"216",488,83,405,182.513703844124,182.769643018632
"217",482,82,400,213.422371558349,171.259925037675
"218",493,89,404,193.268784231874,180.929554694389
"219",471,85,386,204.115950822652,175.281876486228
"220",497,86,411,194.219261674521,178.858374929519
"221",492,89,403,197.617834696547,169.209037714642
"222",489,85,404,190.974947549108,178.42045190157
"223",498,90,408,189.168589139162,171.899923972177
"224",482,91,391,194.930078720765,169.318565120645
"225",485,83,402,189.431746204551,173.525912638506
"226",479,87,392,198.845881043207,175.005033730234
"227",484,90,394,186.220004321961,177.791466457877
"228",465,79,386,209.665323591575,170.90185592711
"229",472,89,383,203.73178742481,173.58562348588
"230",489,89,400,193.459018320893,177.972425354027
"231",493,82,411,195.264559797072,177.471140342795
"232",478,84,394,193.423827242537,184.738821705431
"233",485,87,398,185.333834740531,177.137955709109
"234",493,85,408,198.385748911444,177.459416103311
"235",487,86,401,196.005811037383,176.040349936388
"236",500,89,411,201.825801415652,178.403930168387
"237",502,86,416,189.235003014898,173.567273550935
"238",479,85,394,196.152245131677,175.09426245741
"239",483,83,400,192.182589936222,174.216830710697
"240",474,86,388,189.812955135387,180.830571337116
"241",474,79,395,208.730686821769,174.370694962257
"242",467,89,378,203.010619949208,182.34050742
"243",468,80,388,187.775348209217,176.197599577159
"244",470,81,389,192.649276824633,175.146427925431
"245",498,94,404,197.127945348498,182.020428556223
"246",494,88,406,195.073327506413,178.575164998158
"247",460,80,380,191.765503982294,175.159008387003
"248",490,88,402,209.887015677237,178.073552522438
"249",484,88,396,192.357462638741,176.220749205709
"250",495,88,407,201.269868052186,176.386750395775
"251",486,91,395,199.241865924882,175.817444692568
"252",482,84,398,201.986504432973,174.498409471996
"253",484,85,399,199.355683961316,176.532605735863
"254",500,89,411,193.922285799023,177.374772469623
"255",463,82,381,189.797030037587,174.193883781057
"256",482,80,402,182.566385514477,176.824911650962
"257",494,87,407,183.760307600662,178.280237073925
"258",491,82,409,197.190183652139,175.767238712587
"259",500,85,415,190.189284698354,172.431496744868
"260",484,90,394,195.752003846942,177.328265001427
"261",483,79,404,211.205868726823,185.223304127309
"262",484,93,391,177.832970954125,176.037687943816
"263",483,82,401,199.463988134573,172.454127364252
"264",497,83,414,189.452836568183,179.2566379233
"265",480,91,389,191.383059883189,178.32709000382
"266",473,74,399,187.948178972353,177.522514651522
"267",485,79,406,200.321011640133,184.016982402399
"268",483,89,394,195.959301656271,177.844839629394
"269",484,90,394,176.550591778013,179.242117975844
"270",478,83,395,188.992160505724,177.419181291599
"271",495,81,414,190.087086691255,180.852770067962
"272",484,85,399,181.969762801907,177.235984043189
"273",483,81,402,200.208167821186,178.097684557155
"274",483,83,400,190.17045163714,181.612336381686
"275",473,82,391,191.542099867144,180.378168901325
"276",466,83,383,186.515383769109,180.533663499754
"277",500,86,414,193.606903529649,176.709901988736
"278",486,81,405,204.293016798957,174.942670639764
"279",471,78,393,194.030175953814,173.798288878401
"280",484,95,389,206.45412390197,175.54647051253
"281",485,92,393,211.815863644119,179.945369313394
"282",485,92,393,189.126184376989,183.331324759624
"283",476,83,393,185.928557340287,178.110556039787
"284",482,79,403,189.635873385917,172.841749837746
"285",480,85,395,206.56460948827,171.357514710703
"286",487,86,401,198.859628467564,180.293933359763
"287",472,77,395,191.704578092336,178.698355716958
"288",477,82,395,202.43820041826,173.610515625503
"289",491,79,412,190.076406884441,179.664738248733
"290",461,85,376,187.776381308548,173.296371713698
"291",475,98,377,202.504050047644,177.930904970983
"292",473,80,393,216.485561789244,168.662365448657
"293",492,89,403,200.66506486224,176.443734788231
"294",489,95,394,195.87358833032,181.024730552997
"295",487,91,396,205.57140430055,175.383522968184
"296",502,85,417,189.829462984322,177.246907744225
"297",482,83,399,204.053308890693,172.541158596752
"298",471,79,392,190.593618408207,174.609441617282
"299",472,83,389,195.02424082368,170.371301796846
"300",487,83,404,198.176629026057,175.437001428907
"301",486,84,402,194.90989777967,175.060488275608
"302",469,85,384,192.368946342478,181.064835780628
"303",491,87,404,199.497273494477,178.093821456588
"304",487,83,404,192.019796888311,178.5847182944
"305",497,93,404,180.429863699914,179.533605913227
"306",476,92,384,181.301565769394,175.435779026355
"307",483,90,393,198.224174001471,176.227272199174
"308",471,89,382,193.96073467305,176.97608068922
"309",477,79,398,188.378617012966,167.539560728524
"310",478,90,388,189.450740207588,171.224691799976
"311",486,77,409,192.445413138689,180.627518605848
"312",482,91,391,199.836958378729,174.605070930248
"313",496,92,404,186.255348683056,180.053978924745
"314",492,83,409,199.933465455385,176.564883734856
"315",464,80,384,197.917976870298,182.766057420398
"316",484,85,399,202.785770111006,171.976256144941
"317",471,86,385,206.413410355986,175.809984641868
"318",484,81,403,213.912035201066,178.569132794147
"319",478,96,382,196.292706736257,175.350001876194
"320",458,81,377,193.685635044956,182.159679600048
"321",479,85,394,197.288541587574,177.950407994168
"322",468,78,390,198.322343751202,173.026776319629
"323",507,101,406,204.328664284895,170.579935742433
"324",483,87,396,189.031857412278,176.026499901165
"325",491,93,398,179.448343589046,182.682661603392
"326",477,86,391,193.166835960441,171.999447805728
"327",488,92,396,189.436273284546,175.721338103721
"328",496,84,412,189.401672699021,180.370825190465
"329",479,87,392,185.195364369732,172.484997842458
"330",477,89,388,192.62458835522,175.395586729915
"331",483,81,402,192.031166195574,181.063713870668
"332",498,92,406,187.982188635447,176.686599817439
"333",476,84,392,194.087613605809,173.581783881656
"334",483,87,396,185.954954553275,179.516266001347
"335",502,87,415,191.763182230987,175.603376464617
"336",489,82,407,199.275026025376,170.582470329532
"337",496,89,407,196.791999167035,179.484601145231
"338",488,87,401,194.749195763893,176.495622511151
"339",483,78,405,205.140211975076,179.002860897507
"340",480,83,397,208.892578639641,175.237894757459
"341",484,78,406,202.516779119184,172.88686505382
"342",491,82,409,208.510384701945,185.321274075229
"343",484,92,392,191.591275531816,180.453141199145
"344",483,83,400,199.484559341549,181.747495381272
"345",484,81,403,192.67530133918,181.358420116122
"346",486,79,407,200.157369117368,181.289989249841
"347",481,85,396,196.89272176187,175.113160723403
"348",506,99,407,192.508595498632,176.447002264104
"349",478,85,393,199.624943637653,174.995067674635
"350",481,81,400,197.54406415885,172.630581530257
"351",477,86,391,186.213028768265,180.816011183795
"352",478,86,392,194.593804948023,177.998810348681
"353",494,87,407,195.639186652347,181.782549668336
"354",497,88,409,197.534902644578,178.882501500559
"355",494,87,407,197.948153820088,173.411603057027
"356",483,89,394,190.935748075231,179.086233086031
"357",496,90,406,194.49436969561,175.346145126749
"358",498,84,414,194.249334394667,177.843776538744
"359",480,79,401,195.08493536836,175.377205266973
"360",499,84,415,198.054686416394,174.325088182432
"361",481,87,394,202.524782523193,178.396290738522
"362",486,87,399,195.21809498809,182.079841470977
"363",496,80,416,192.013136745328,179.813578411894
"364",489,85,404,183.412086586784,182.366732386624
"365",487,88,399,200.308580605978,173.446591665396
"366",494,89,405,197.020639399094,178.135317494697
"367",489,93,396,191.360049752039,182.780231889554
"368",501,90,411,209.895514933165,177.663685731166
"369",486,83,403,209.013443355093,174.931475476583
"370",488,79,409,201.723289566689,169.363268402188
"371",486,88,398,193.512349740844,176.096920096563
"372",482,87,395,188.956257833264,175.651917883864
"373",495,86,409,187.531869790267,175.247108778722
"374",468,82,386,201.645366040343,174.559882907827
"375",474,87,387,198.551873162258,177.026283689767
"376",499,87,412,203.010613233842,177.748275163098
"377",494,84,410,183.337303751226,179.969680799766
"378",486,87,399,201.903914247126,171.600266877232
"379",482,84,398,204.78237717643,177.764103405701
"380",483,83,400,178.386914651484,175.659893481981
"381",504,97,407,196.20370225211,180.820432265254
"382",497,88,409,192.578827142487,173.951462240285
"383",482,70,412,205.342907142547,177.889205987139
"384",491,89,402,186.487669682937,184.564695868949
"385",492,93,399,191.246780134771,173.028164158943
"386",477,81,396,189.60434061698,176.096997048512
"387",485,90,395,196.651027521889,173.336318197766
"388",495,85,410,193.226216661512,175.513595866306
"389",467,81,386,193.12202305849,175.426510722066
"390",489,83,406,185.348207590215,174.304134388603
"391",488,92,396,201.478775496446,178.980729733655
"392",479,85,394,192.719353475294,176.060386834913
"393",499,90,409,200.26607550818,172.065920882641
"394",489,90,399,203.389054402501,178.314608326795
"395",479,85,394,206.863567110466,176.380435439001
"396",481,83,398,204.868778765787,179.26213265793
"397",482,83,399,193.53714980164,177.628159249466
"398",477,80,397,203.367989116115,184.515126397975
"399",476,82,394,196.882375202291,177.341879162116
"400",478,91,387,192.568730668579,175.416471132077
"401",497,84,413,194.775934007804,174.331824064388
"402",480,87,393,188.283869834328,182.239627550349
"403",480,85,395,201.262374899592,176.753084457171
"404",476,83,393,197.708011176771,175.255909157467
"405",478,84,394,201.582249747358,182.344914569864
"406",486,85,401,215.255222368628,174.61391606404
"407",487,81,406,190.95419016014,173.495766904828
"408",475,87,388,205.14681974621,170.868105378364
"409",474,79,395,197.255301693859,171.129137728209
"410",483,82,401,196.265207417145,169.928285374477
"411",484,87,397,192.138528822209,175.907892915311
"412",471,91,380,187.979574361,170.010710201732
"413",495,86,409,189.847909211402,175.508560171826
"414",467,78,389,191.312575235974,184.142046814794
"415",476,87,389,186.652865295869,176.296393973184
"416",490,89,401,207.777520093921,176.916523120978
"417",489,80,409,192.391998575823,177.287866473901
"418",485,77,408,200.500390685067,174.790768214742
"419",480,86,394,199.092540727546,181.131063349428
"420",489,83,406,200.015397847932,167.285198260697
"421",487,96,391,185.799910794363,183.336459514303
"422",489,90,399,211.638587385362,179.624905695973
"423",464,85,379,195.199413798019,176.257073162986
"424",467,86,381,188.229067163788,175.804658289322
"425",497,82,415,191.638165919236,179.640288377179
"426",479,84,395,202.642466297197,182.521034949148
"427",491,90,401,176.823767911982,178.601760875012
"428",489,88,401,203.413243336769,177.981207242167
"429",477,88,389,192.558030112006,177.835696420654
"430",486,86,400,190.013802495509,179.512535927106
"431",476,80,396,197.783588049234,174.440332159047
"432",478,81,397,203.741945768537,174.249850830074
"433",487,86,401,181.283190737408,172.970765430418
"434",476,83,393,199.700703130207,176.110360845701
"435",480,92,388,201.586244236831,179.76174723233
"436",463,85,378,195.129877070865,183.572562018719
"437",483,89,394,195.079734783456,173.374002335664
"438",502,102,400,183.339222186298,176.831661498173
"439",496,92,404,198.797193870258,171.556400552503
"440",489,80,409,194.090835900387,170.557110877233
"441",489,87,402,195.122093256362,178.654400090657
"442",491,85,406,198.020975134431,172.605644101911
"443",486,82,404,193.941612072019,175.669775649202
"444",488,81,407,192.434243132856,186.32645873956
"445",486,91,395,202.685468469051,171.305871021998
"446",489,95,394,207.067987842875,172.249749544717
"447",482,81,401,189.730636792874,179.389904915355
"448",491,85,406,201.303086290668,180.844470301441
"449",479,84,395,195.162932112978,177.142531323363
"450",486,86,400,183.808439159047,173.039754017519
"451",491,85,406,195.830869024068,176.031547871388
"452",489,83,406,188.645742590898,174.866366723511
"453",489,83,406,198.970580441469,176.335992786975
"454",478,81,397,201.639359945989,177.256827199464
"455",494,89,405,185.239008609386,174.238578725557
"456",472,82,390,200.608438368953,179.36931407267
"457",484,85,399,213.9676612603,177.758593162834
"458",489,75,414,198.022336176794,180.923319546417
"459",485,96,389,182.787195948845,176.340019978752
"460",467,84,383,200.561711916607,184.501882412458
"461",489,88,401,194.104839191065,179.183475715378
"462",483,85,398,196.18295734812,178.933501220089
"463",483,90,393,195.468792791866,178.259614473774
"464",483,90,393,206.358954240902,180.171489332984
"465",486,92,394,189.192205886856,175.609145279033
"466",468,87,381,193.578669576088,172.694827497221
"467",488,83,405,186.043827518345,176.162155214474
"468",485,90,395,188.234477218639,178.398985181189
"469",481,87,394,195.329114422733,180.796806655651
"470",479,83,396,194.891854736493,176.02826460172
"471",476,88,388,202.157434990547,181.8351950023
"472",469,80,389,190.273327846554,178.874927779651
"473",478,81,397,198.443219667994,180.834798985673
"474",499,88,411,194.586999954722,174.987564996722
"475",497,90,407,198.576231602348,181.618963465397
"476",491,85,406,189.897886898737,179.821852546951
"477",456,82,374,189.445027868625,176.01276704811
"478",505,88,417,190.092182900277,176.109768263581
"479",483,84,399,208.539609041653,173.433477391804
"480",481,88,393,183.79616877527,174.969053721508
"481",474,82,392,192.861394669041,169.347485902061
"482",485,86,399,189.508478484317,173.431102204437
"483",492,89,403,193.874630029118,177.82014135574
"484",470,83,387,195.057068908647,166.103440332564
"485",474,89,385,201.365524171177,180.303864558031
"486",479,86,393,180.691825549968,182.807115249144
"487",482,87,395,188.750032870828,169.166921960346
"488",475,83,392,196.299251719629,171.233735460257
"489",504,99,405,199.835780488334,175.790610699672
"490",485,85,400,204.346688663443,182.529857813473
"491",477,81,396,184.770420752457,175.574591544241
"492",486,85,401,191.182313753856,169.365105303385
"493",497,89,408,187.226965997566,178.635317682685
"494",478,82,396,197.631758921841,175.220288278913
"495",483,86,397,196.211340516422,175.928623148948
"496",490,79,411,191.561123769028,171.973990271536
"497",499,86,413,191.286899641646,176.646829770771
"498",492,89,403,197.444611572655,177.67575679088
"499",487,92,395,196.276883039376,173.531903314874
"500",496,86,410,196.444221113465,184.541312363987
"501",476,81,395,209.254341989907,177.745474452163
"502",479,84,395,190.267666416143,183.795655453232
"503",494,91,403,191.293608529093,174.515381677282
"504",473,89,384,190.094009399886,176.640902263122
"505",479,86,393,200.692717971057,176.09160950947
"506",494,89,405,190.780594394375,175.137847590408
"507",494,90,404,195.257568489161,181.633442843372
"508",482,85,397,200.326525465248,178.620869625327
"509",481,80,401,197.79326706532,179.369528093182
"510",492,94,398,178.694075338662,174.699963702515
"511",486,86,400,204.115394910524,171.827657210142
"512",485,86,399,192.413095184812,179.038229940249
"513",494,92,402,189.530169027439,177.290259859604
"514",492,82,410,202.570961893639,180.17823777297
"515",509,86,423,188.700759583356,168.497550688914
"516",474,81,393,197.295349172931,176.953648880174
"517",488,85,403,193.541024835103,182.214982644353
"518",493,92,401,194.43026902258,174.494576367915
"519",492,81,411,197.738263540431,177.882863605597
"520",488,87,401,192.86789584679,173.27980351983
"521",493,84,409,209.482686968189,177.762621374337
"522",494,95,399,192.59610076021,172.120021780252
"523",493,90,403,190.964804114135,180.148103798513
"524",482,87,395,201.053065825254,176.199347439293
"525",469,85,384,197.367252136103,176.376544407264
"526",480,84,396,198.61924459955,172.898720639934
"527",467,81,386,186.118276123948,179.989971009132
"528",480,82,398,199.402669168675,183.144616709348
"529",484,88,396,191.217642354776,176.146143890645
"530",471,83,388,214.581450816795,178.72599198655
"531",478,85,393,202.018200117989,177.211837023706
"532",488,82,406,192.113328668053,182.333478352095
"533",481,89,392,198.557077213145,174.437331170592
"534",499,99,400,197.790283474702,178.951898537373
"535",481,88,393,196.800222193124,172.22500719077
"536",485,94,391,192.217894691383,175.183196555409
"537",472,87,385,187.323532568818,173.618740701627
"538",495,86,409,192.815010899812,178.892007756916
"539",467,80,387,200.432964997588,175.523801684085
"540",499,88,411,193.755397383077,175.092153449168
"541",497,103,394,202.382765084476,182.686491848023
"542",479,82,397,206.777104176958,172.74410397614
"543",489,84,405,203.067481814331,174.806610177879
"544",488,79,409,193.470278425597,176.56013101732
"545",476,88,388,193.646120784863,179.146271181299
"546",484,87,397,187.99857323168,177.226228942653
"547",508,79,429,181.914964731201,181.187435435977
"548",471,84,387,193.405457851777,182.619433962078
"549",492,89,403,200.652378775586,166.287251695396
"550",478,73,405,200.944338039577,171.698962931981
"551",500,93,407,199.371080998238,183.133670309592
"552",500,90,410,191.050135641316,178.658137045341
"553",481,82,399,200.881207874511,172.123697494348
"554",473,78,395,209.75706516877,179.379052147779
"555",462,83,379,192.66654984264,174.183858602154
"556",485,86,399,187.855892220553,174.91734851575
"557",484,87,397,201.244487124857,179.542525113835
"558",475,83,392,203.760299173368,176.996455706201
"559",471,78,393,188.64958810554,175.82408155739
"560",482,86,396,194.659735936023,172.964129445502
"561",501,84,417,202.091243695405,175.767236436663
"562",487,90,397,205.455218502908,180.979297490438
"563",473,85,388,199.17409376774,174.629040265607
"564",478,91,387,184.092571749858,175.785847702897
"565",492,93,399,201.964888308783,178.799483706182
"566",477,85,392,190.330496362637,181.3293714287
"567",470,83,387,194.185949903165,184.812382283677
"568",491,83,408,194.208202392797,172.273922795384
"569",488,92,396,187.623098481643,173.490348167012
"570",470,81,389,204.679789580389,172.54000435314
"571",474,84,390,189.604842997165,173.844425304251
"572",502,81,421,192.988592027574,182.718433059646
"573",487,87,400,206.253694419268,169.208847345018
"574",484,84,400,201.027569471049,183.633696785468
"575",512,84,428,187.110218203398,176.441071725463
"576",489,91,398,198.402127223382,177.682929015464
"577",478,84,394,191.929492029199,175.932331196253
"578",483,80,403,204.998365291164,175.978542531034
"579",484,83,401,190.306398117218,179.363190380481
"580",493,95,398,205.41734967093,175.448362415604
"581",488,89,399,190.786544002302,175.873158799403
"582",490,92,398,206.384183943253,174.528282808817
"583",487,92,395,196.257702435293,180.976306150093
"584",488,89,399,189.768926827888,174.771616462513
"585",490,82,408,185.254371179995,176.528714224317
"586",476,83,393,204.698475640354,182.546617270056
"587",477,73,404,193.667844252833,175.531613971417
"588",464,85,379,196.040639031998,176.676349710654
"589",494,87,407,201.7167293437,178.088695970073
"590",480,83,397,190.377394011735,172.930300545895
"591",488,90,398,179.766151145639,171.748410256978
"592",479,79,400,193.214990871526,169.458106129016
"593",488,90,398,190.98198830426,176.986869353421
"594",491,87,404,190.379279270324,174.312596977986
"595",477,77,400,176.159897450186,176.597262573541
"596",491,86,405,210.955574663143,177.955919996468
"597",487,82,405,193.43644743397,174.065099692799
"598",482,88,394,192.302976565384,176.550915770182
"599",480,91,389,194.488989199605,178.588492645894
"600",492,96,396,188.165490905624,176.878615536457
"601",496,92,404,190.207829332544,174.159856060298
"602",480,80,400,207.269826851344,171.294895795394
"603",484,89,395,196.118169844681,179.33157517733
"604",471,77,394,198.511843375863,175.406570454762
"605",496,83,413,186.503639720643,179.054573200497
"606",503,89,414,199.555898715376,177.197657702107
"607",479,87,392,198.507735438718,174.12811811108
"608",476,85,391,200.2983904752,173.483630554916
"609",481,87,394,191.741912193957,178.559120187664
"610",484,83,401,198.852195713334,171.334032687653
"611",493,87,406,194.899590334471,177.521578209723
"612",479,87,392,186.99175557158,177.260224645728
"613",487,85,402,188.558477148483,179.572985325251
"614",494,90,404,207.52043397225,173.087732526025
"615",497,89,408,194.608488165358,183.517438189706
"616",474,80,394,211.912021498135,171.870479134476
"617",483,91,392,202.492511864492,173.774984263419
"618",491,91,400,193.114896709797,172.29764280354
"619",498,90,408,194.224164878251,180.113024614958
"620",476,80,396,203.907975673422,174.07609560826
"621",478,79,399,181.135959562858,180.713247150955
"622",472,81,391,206.865041883258,184.523233863469
"623",477,84,393,197.346358018621,175.511462482341
"624",469,77,392,188.488789805569,179.361942307566
"625",482,94,388,188.519164592225,182.881831519521
"626",492,91,401,186.175030774757,174.084744629853
"627",485,83,402,197.164412749655,178.747976619103
"628",483,86,397,192.288382426763,178.82513481932
"629",479,86,393,194.67728424741,175.322650046411
"630",481,90,391,190.899654745534,180.488752817714
"631",478,87,391,199.755466807454,176.217947268451
"632",472,89,383,191.034332684183,178.867874047127
"633",489,82,407,192.305722540356,177.759577130419
"634",496,86,410,180.327722930278,171.405531856092
"635",481,86,395,190.374562397609,180.677879617047
"636",472,82,390,209.1459421916,170.947987627425
"637",482,84,398,190.966146450105,174.865288882329
"638",479,86,393,202.518866348869,180.929212450758
"639",473,92,381,194.743526715165,176.749372072901
"640",506,93,413,187.826706780579,182.797760953139
"641",471,83,388,196.402746137727,175.778993642526
"642",460,79,381,195.517471850402,168.243395084339
"643",486,79,407,188.512775246755,171.296890576637
"644",491,81,410,203.813494326419,175.015989141995
"645",490,86,404,198.220768035142,168.701452304236
"646",497,84,413,197.347719629345,170.752601879623
"647",476,86,390,204.139674251097,184.571036802137
"648",476,84,392,200.255837994501,179.442197886138
"649",483,82,401,203.740447966772,174.795909112393
"650",488,89,399,201.800577542207,173.986572024994
"651",484,89,395,204.044397026695,177.102566977071
"652",465,76,389,193.057948021873,172.918338472487
"653",474,77,397,190.39068123064,176.837743721443
"654",491,81,410,188.688024843062,183.252473283166
"655",492,88,404,186.126023548407,180.794425530095
"656",501,89,412,195.53805849909,172.983441929724
"657",481,85,396,195.432820936035,174.486614455208
"658",481,91,390,192.505987463954,179.192537285073
"659",491,84,407,184.352565847486,176.215525675269
"660",498,92,406,191.493142413511,177.678731980867
"661",488,78,410,188.240374602155,170.798185032706
"662",475,75,400,182.795309291604,179.240277831908
"663",488,87,401,184.818169245031,176.086806264457
"664",486,91,395,180.657282365144,183.693210651582
"665",470,83,387,196.166352689508,172.567879519519
"666",505,94,411,193.271513764992,176.750887424219
"667",491,80,411,207.63141827019,177.302609267711
"668",464,82,382,212.173378329159,174.233412350247
"669",488,88,400,192.249599423406,171.784880946711
"670",479,80,399,194.819911429888,172.687138159722
"671",485,96,389,182.276981496253,176.595978084078
"672",479,86,393,201.085886359598,170.827531029702
"673",485,84,401,190.33823795513,179.72160108819
"674",507,88,419,199.67829325726,175.637558414863
"675",484,80,404,191.164506939355,175.593075403948
"676",477,77,400,194.5194329518,175.315112322413
"677",499,89,410,195.619586057898,176.656345764217
"678",495,85,410,191.284642391242,182.778398132323
"679",492,85,407,204.023948817803,173.854146984672
"680",484,80,404,188.618658796081,172.148809204838
"681",492,86,406,198.311845059453,173.962497775329
"682",467,87,380,194.835998493059,180.732349955861
"683",485,87,398,193.923571519315,180.127096052666
"684",487,82,405,197.36398167609,175.653697264679
"685",491,88,403,187.721077181905,174.313667460829
"686",514,98,416,191.319078138002,174.750880714228
"687",483,80,403,194.322309906124,172.927575140655
"688",472,81,391,186.529120441648,180.913688375116
"689",467,83,384,200.778574961249,176.50252294113
"690",488,87,401,199.84315726531,179.486757830104
"691",479,85,394,190.06002348789,174.053774773576
"692",466,83,383,187.443376034055,179.683228271392
"693",495,87,408,186.514031344376,177.525513799904
"694",482,82,400,196.195255449193,174.763541471165
"695",481,82,399,204.437098171949,182.878506971257
"696",468,79,389,193.960819556709,173.486234996625
"697",480,81,399,194.777906627488,179.132501301906
"698",488,87,401,196.502353028368,178.667167906876
"699",482,86,396,184.113738164857,179.698247132683
"700",483,94,389,188.866048789528,173.730038805731
"701",478,93,385,191.801733421339,175.238271066081
"702",488,88,400,196.866847788717,176.350750572923
"703",480,84,396,197.438151103361,170.235797030713
"704",473,76,397,183.826580612855,183.245221976121
"705",490,83,407,196.389793100572,177.77848711981
"706",475,79,396,201.991216049917,172.018550672364
"707",490,96,394,201.140149408534,181.257482173745
"708",488,78,410,196.781057288311,179.928682480801
"709",480,87,393,193.148360856942,179.924174508779
"710",482,81,401,219.161227246006,176.942535268658
"711",504,90,414,198.360528033128,177.328550714826
"712",482,82,400,210.335036590156,172.629336043707
"713",477,83,394,186.382270631487,177.978299487232
"714",487,86,401,182.787872747605,174.735872939469
"715",486,83,403,196.898629696667,173.553151115881
"716",487,84,403,198.982676786962,183.605126879919
"717",492,84,408,198.020510175455,176.777836347889
"718",496,86,410,198.604021258743,174.127655275613
"719",487,87,400,193.111145143707,177.461186701417
"720",488,84,404,206.499874644036,184.731303952261
"721",502,89,413,199.925926226137,177.674815041357
"722",478,85,393,191.141632156983,169.93689265811
"723",472,86,386,201.204635571505,178.052100779647
"724",487,83,404,197.114332634871,177.516353116293
"725",498,89,409,195.906071952827,176.950161910363
"726",479,84,395,168.049640830313,174.950863775982
"727",481,90,391,195.418819704224,173.263797816185
"728",497,85,412,190.084715803678,172.174899850309
"729",481,89,392,201.540694945332,173.080008918521
"730",478,89,389,192.471525955669,174.642616799627
"731",482,81,401,202.036101032924,176.080849772399
"732",492,87,405,184.097648469707,177.898764690548
"733",480,88,392,196.199155011932,178.723749995985
"734",485,86,399,191.703821532708,174.263878134269
"735",484,84,400,185.744843433657,182.755641494853
"736",474,91,383,195.326955563676,179.376940904937
"737",498,84,414,205.119584495192,172.884906516309
"738",479,79,400,185.916552108451,175.468954973603
"739",472,86,386,183.193522499787,170.693832134653
"740",476,86,390,199.177385622984,181.547317517937
"741",478,87,391,205.485963402459,181.838452823625
"742",475,85,390,191.289890468371,182.008035678169
"743",487,91,396,198.864278850087,175.600428279915
"744",481,91,390,196.566972030608,172.15172162047
"745",499,81,418,205.990208401314,171.891164910865
"746",484,85,399,200.789045537601,175.535786781888
"747",501,87,414,187.104918674802,178.713333445342
"748",485,87,398,195.293961987274,178.119442307295
"749",502,88,414,205.225077944154,175.477155787369
"750",465,91,374,190.949410674439,176.639518348625
"751",477,83,394,189.024696358587,169.743932325932
"752",498,87,411,208.150026933595,171.831034749057
"753",462,72,390,210.289444274301,178.689629516122
"754",478,80,398,189.5412413552,182.234894844794
"755",481,83,398,200.110228666062,173.706726702254
"756",488,85,403,194.929493652711,180.429102647774
"757",483,76,407,214.358220736553,180.116498745748
"758",488,93,395,191.006096808835,170.428612013572
"759",472,84,388,196.814474386586,175.378129908179
"760",486,83,403,190.504664027419,177.909812297321
"761",484,82,402,191.393907666953,171.699131770443
"762",496,86,410,195.719056485159,176.797869261639
"763",475,90,385,205.388686328469,170.713346009172
"764",476,81,395,191.064131696577,176.42696190756
"765",475,86,389,194.143211575481,168.065426304061
"766",486,90,396,195.809807502895,169.530085945497
"767",488,87,401,192.910654777476,175.033111887295
"768",466,86,380,201.95211001851,174.940462679493
"769",495,78,417,198.195482049846,173.653908825261
"770",471,85,386,213.335106317124,172.100117662292
"771",503,87,416,218.900061655967,182.663755764114
"772",492,86,406,192.227964064517,173.088533784641
"773",489,90,399,198.365882523447,178.941166523975
"774",482,88,394,207.62485944666,174.80394802398
"775",478,81,397,184.267528864242,178.010139795294
"776",487,81,406,198.077876567501,176.118386241896
"777",465,78,387,192.722157582754,177.933219431902
"778",510,103,407,202.798313690974,176.357969423926
"779",486,90,396,192.83630049752,181.085561393025
"780",475,86,389,196.636421606443,174.712328577294
"781",476,76,400,195.890390203935,176.426315659971
"782",469,83,386,195.254360265326,172.438579649167
"783",494,91,403,196.512517145734,168.305628170231
"784",510,95,415,193.79760551047,183.462608240399
"785",474,83,391,195.775159230288,176.564347046321
"786",483,97,386,186.149529540202,178.507899010242
"787",480,87,393,196.984281755492,174.648397979235
"788",505,92,413,200.175495657119,182.365000889906
"789",479,79,400,207.210169104828,177.312851319067
"790",493,96,397,192.6461447062,172.655070719182
"791",467,80,387,208.687938271538,182.753726229015
"792",486,90,396,187.844082872815,176.848900881183
"793",483,77,406,191.832888135364,175.029926692888
"794",471,86,385,197.452664445299,177.000782371655
"795",468,78,390,196.667642644723,179.953642791218
"796",491,80,411,193.369532459946,179.330745666884
"797",474,86,388,180.881484808859,179.834235486862
"798",481,83,398,202.373707637628,173.855357016619
"799",471,82,389,189.506214493593,175.959902912668
"800",488,86,402,196.317631680036,175.890873396941
"801",475,80,395,199.545051283095,174.478534069857
"802",476,77,399,184.688582437951,176.486886201501
"803",481,87,394,194.956296744969,178.646615599259
"804",502,88,414,195.355866964505,178.935288685981
"805",480,93,387,190.105841944719,173.537276330899
"806",479,82,397,210.331279218745,178.352459466546
"807",478,88,390,204.340481735712,181.080849139733
"808",488,88,400,200.148357821401,182.74519767397
"809",483,88,395,184.989134755888,177.185205809245
"810",479,83,396,196.020042342893,177.667391069858
"811",501,77,424,198.276438366995,177.729865880668
"812",482,84,398,193.445159183601,173.27751211288
"813",484,91,393,191.804271595017,177.725883440373
"814",473,83,390,194.907120687263,186.036514423779
"815",484,80,404,182.186064185358,186.490079790863
"816",493,86,407,202.433541832733,176.020194643338
"817",495,88,407,202.468993098744,171.702476606887
"818",481,89,392,195.408255800206,173.362825866617
"819",471,75,396,188.546110707213,179.426555512624
"820",483,79,404,194.465161974872,183.816438460326
"821",480,83,397,199.280700983346,172.641212952414
"822",478,90,388,193.99259464815,179.713717852728
"823",485,93,392,197.463762696033,174.068607387621
"824",491,84,407,197.852062551666,175.299024293706
"825",475,83,392,202.388885914861,176.384880951438
"826",502,87,415,195.38301799314,169.793275703088
"827",478,91,387,200.156909152631,172.395524451316
"828",477,84,393,190.793172171078,169.780353042444
"829",480,83,397,199.538385312551,177.431614457287
"830",482,77,405,193.957150198816,170.80826019067
"831",473,89,384,186.539494656919,170.246182530907
"832",497,93,404,194.914037125916,177.100389043644
"833",483,87,396,186.020146395195,174.568270359659
"834",482,80,402,185.181070951932,173.738718192279
"835",481,84,397,185.405898973222,167.982188616713
"836",501,90,411,198.814044906062,181.340566372566
"837",474,92,382,201.905066867133,176.174067850403
"838",495,85,410,189.793191716601,177.446225051012
"839",478,78,400,198.286406164365,173.862797518193
"840",479,94,385,201.265926360936,178.353375451501
"841",470,80,390,188.821622820822,172.29484033013
"842",514,88,426,203.822360977265,180.45940900948
"843",479,85,394,199.628176940219,172.378659392209
"844",479,76,403,195.004728842208,167.134282994608
"845",483,84,399,199.807202136724,175.123178546039
"846",494,84,410,198.548026758999,177.702727505849
"847",490,85,405,190.374898950242,176.590366924597
"848",494,92,402,198.163670125465,180.249982448836
"849",497,87,410,190.57588266982,172.388473521939
"850",478,84,394,194.032487234897,177.282050183594
"851",465,88,377,211.446891021546,173.063889994643
"852",484,76,408,185.380882019685,173.271575115272
"853",476,85,391,199.864897562911,177.447259377403
"854",490,87,403,189.328576411501,173.160059262629
"855",481,82,399,195.967017059175,177.139238854025
"856",486,101,385,198.524448632924,182.496318083806
"857",489,86,403,203.419072726533,177.733049810637
"858",484,87,397,191.463613530587,172.740273242666
"859",498,90,408,197.930664526212,175.124291188537
"860",478,81,397,197.339195557228,177.348773722157
"861",508,88,420,186.928377503372,181.403452089009
"862",469,84,385,197.848628118606,175.559779330137
"863",478,76,402,199.053183769411,178.136059678111
"864",492,80,412,191.743848887691,179.280710431469
"865",484,79,405,183.515904394318,177.435320867856
"866",501,91,410,193.718187594613,175.729073012959
"867",502,84,418,199.043405515053,174.852117111193
"868",459,76,383,189.73671000949,178.989238872191
"869",481,82,399,195.901458272677,172.819538382753
"870",480,88,392,200.215089484049,181.900597621271
"871",474,87,387,185.844874750665,175.668590355924
"872",478,77,401,213.371671691532,174.481923611753
"873",487,86,401,199.312063427109,177.400606024342
"874",465,84,381,196.154729716335,172.479557150382
"875",498,92,406,176.586464356449,180.412975377872
"876",483,91,392,199.772416728123,176.267124928838
"877",502,91,411,198.429774110947,179.95527383561
"878",497,87,410,202.802188069477,173.71718408211
"879",484,89,395,195.190580892677,176.617703824089
"880",493,92,401,190.499725231592,174.333434858585
"881",477,82,395,205.632887473569,181.017290178458
"882",495,88,407,215.566837238451,176.833578738091
"883",484,87,397,195.894633273112,173.851114958432
"884",469,85,384,190.478407733494,176.652536018806
"885",464,81,383,190.121137130729,179.966098059532
"886",496,87,409,183.552202302596,168.052130479191
"887",482,89,393,192.7100558684,180.395660850463
"888",489,85,404,191.254316268524,176.686880701068
"889",501,85,416,191.093069944949,176.349642359931
"890",490,87,403,192.765196442519,177.132206815507
"891",498,84,414,198.47836552672,181.952847393404
"892",478,83,395,190.129610777851,175.635627485925
"893",494,88,406,199.706501205535,176.521818997733
"894",492,82,410,204.136152451481,174.250476617436
"895",488,94,394,189.257028962716,174.834292570322
"896",500,85,415,200.770335868358,177.056239697643
"897",474,83,391,185.790880930583,177.236102824474
"898",463,77,386,198.838615351365,176.024975097558
"899",478,86,392,197.90922511328,172.876326222329
"900",491,94,397,206.169338183517,178.153270173064
"901",497,87,410,195.258409775341,179.296858947792
"902",468,85,383,207.104977256624,172.485484582034
"903",479,90,389,206.17070434557,178.690952252086
"904",496,87,409,191.986950878147,179.770223330155
"905",471,84,387,202.903646076763,172.717274162561
"906",483,89,394,192.825553366134,177.723001537615
"907",476,82,394,202.713374677041,180.008328973899
"908",476,73,403,186.188147136272,172.659110839355
"909",458,77,381,201.281727926421,177.015149457809
"910",480,82,398,217.872052955753,178.731305894521
"911",488,97,391,187.457768084486,180.349907126563
"912",479,84,395,192.469248609089,175.341378393366
"913",501,96,405,189.570122914689,179.759398687011
"914",511,94,417,179.504399036859,184.278177588332
"915",474,77,397,194.993095596572,178.294473460242
"916",493,88,405,186.610218766969,177.174393402395
"917",480,86,394,195.896932416954,173.695322985297
"918",499,88,411,187.264103970641,179.260282754196
"919",492,85,407,179.657543326758,179.796433774578
"920",478,91,387,197.177550991605,177.35764841026
"921",487,96,391,192.185864322623,173.495775212557
"922",474,74,400,204.703961264758,186.108858951407
"923",494,93,401,184.240624354604,175.369157977412
"924",496,89,407,195.016355092384,173.582082905795
"925",488,83,405,207.409990494298,180.21099432207
"926",490,85,405,197.033980949039,178.675749853332
"927",495,88,407,196.291202884409,176.52726725044
"928",479,87,392,193.542166105727,179.348868626077
"929",491,84,407,196.497046304563,178.967170437692
"930",498,85,413,203.792717521156,178.44197878503
"931",491,93,398,199.981663298996,174.820660943961
"932",483,92,391,199.827818636175,181.171569940515
"933",491,92,399,188.754053478431,182.475270936408
"934",477,81,396,196.831234286967,175.510845604796
"935",483,83,400,198.973770433161,174.092169758944
"936",482,82,400,196.942924488133,174.569841191052
"937",477,85,392,204.822239872867,179.681224865642
"938",486,88,398,191.331256389878,178.302271024665
"939",488,87,401,195.648744425926,175.004560470537
"940",500,87,413,195.160044903682,177.211741854837
"941",473,77,396,188.959580822776,174.626810338702
"942",478,82,396,195.279075587003,177.325871757548
"943",487,88,399,197.598149942554,178.256147961495
"944",491,88,403,184.840292877434,175.817006125982
"945",492,92,400,188.368751838056,170.382175367213
"946",481,90,391,188.368151100302,180.011988566622
"947",506,98,408,177.840361752721,176.818564655659
"948",489,85,404,194.75258559763,176.624282585169
"949",477,83,394,197.635526815297,172.188904870255
"950",489,87,402,196.289332899553,179.909775769197
"951",476,93,383,197.719452945944,176.991899169353
"952",484,90,394,190.495509546668,179.576809072476
"953",477,88,389,191.289000039606,174.738600996014
"954",471,84,387,193.813848504847,169.164788995269
"955",484,86,398,182.44178540811,181.101709333254
"956",475,92,383,195.554338098861,176.170841483546
"957",500,77,423,188.559227108787,173.006784834487
"958",476,87,389,198.870612790523,182.219974783
"959",494,83,411,187.394643901569,177.231920619799
"960",478,84,394,201.368126157986,181.407911631249
"961",479,86,393,191.173542941074,180.297550808211
"962",484,84,400,188.899220728404,175.906649597999
"963",486,80,406,176.687280114059,171.930683187487
"964",469,92,377,198.543789430051,175.937581133396
"965",485,90,395,192.507469744047,179.349647728852
"966",493,90,403,200.817243201348,177.310993802687
"967",500,88,412,195.744031901541,186.268732071158
"968",488,86,402,197.243127657371,176.3745191667
"969",493,88,405,202.094526887223,175.683734748789
"970",472,81,391,187.025809028347,174.629377742521
"971",477,80,397,209.016219202882,174.244831301293
"972",484,83,401,208.872578221832,177.763838976691
"973",487,85,402,200.531421548587,170.917465935703
"974",489,85,404,202.76151778829,176.124615527788
"975",494,88,406,187.745884221277,184.343728156829
"976",475,79,396,182.534071848144,176.157870510584
"977",488,88,400,199.45772441821,177.558788102826
"978",479,80,399,192.322992609098,178.447344163045
"979",511,92,419,194.319501415102,173.664457686738
"980",479,90,389,188.268041779053,172.18760516239
"981",483,84,399,193.341506026129,179.920598046187
"982",487,87,400,194.41070594755,177.024580162536
"983",473,87,386,190.230040215667,170.88901246013
"984",512,94,418,191.395725131077,172.579889227858
"985",466,79,387,199.619625020932,177.742937464674
"986",475,82,393,202.441380660416,173.752855013281
"987",477,82,395,201.03830694532,177.883603369175
"988",476,79,397,205.780476879318,176.083933771753
"989",482,82,400,212.801603458277,177.332036912227
"990",490,88,402,180.494687797744,176.29388623495
"991",476,83,393,205.303932476086,179.342796202854
"992",487,90,397,200.206363342131,179.250097631049
"993",489,84,405,201.244710996574,177.540800880858
"994",480,84,396,189.884812726382,175.632959861713
"995",470,75,395,192.429930885821,181.504599334745
"996",476,81,395,204.499581777283,177.310772010215
"997",469,75,394,197.479677163541,174.314131055073
"998",494,82,412,192.201124732346,174.101161975213
"999",486,78,408,193.380945394486,174.472153133475
"1000",483,90,393,188.778657075616,169.513486579169
"1001",470,85,385,190.763408450734,177.461176340615
"1002",490,88,402,191.961887478472,181.272170496542
"1003",490,80,410,203.810867245208,178.860567713066
"1004",480,89,391,204.105449423947,185.551378289873
"1005",490,84,406,206.530976346619,174.858329991518
"1006",475,84,391,195.06339036579,177.891254460125
"1007",471,84,387,198.3491102767,179.656053698743
"1008",482,88,394,196.254805116627,182.056977812439
"1009",486,84,402,194.072057245322,175.945646731644
"1010",506,85,421,191.49044928609,175.247071873069
"1011",494,88,406,190.373572257275,180.132871143321
"1012",505,82,423,194.6345311792,181.86721220865
"1013",484,87,397,185.821167266103,179.015550832912
"1014",481,75,406,191.956979109246,177.483060498556
"1015",498,89,409,197.057793078197,177.385282220495
"1016",488,90,398,204.526997815951,172.17243868429
"1017",491,80,411,197.839094704408,179.695896042498
"1018",478,80,398,191.076383170064,182.290722113822
"1019",485,86,399,194.040019863517,172.06924089639
"1020",481,81,400,186.97279999005,174.523891359989
"1021",486,87,399,197.468894240517,177.254808014741
"1022",477,82,395,203.651850095662,168.702470701381
"1023",476,84,392,182.445492798126,171.694717498486
"1024",499,89,410,195.804917143386,173.367688031132
"1025",482,79,403,200.354732228967,179.463218119981
"1026",483,79,404,198.2613823214,177.211420450293
"1027",455,82,373,208.829372024018,178.251165905944
"1028",486,82,404,197.621749302179,178.643460280797
"1029",485,88,397,194.270306571066,169.969850827523
"1030",476,86,390,185.340594099424,177.347939552514
"1031",493,84,409,199.622100051037,173.992004542264
"1032",468,87,381,193.629972213979,172.860883576205
"1033",467,82,385,182.42956990202,172.940104273945
"1034",484,86,398,196.315098964017,172.939731824149
"1035",481,80,401,195.515636250229,172.419032670175
"1036",472,73,399,197.923992501053,184.31484596317
"1037",499,87,412,191.966149642787,182.678807700712
"1038",491,90,401,182.584562846061,173.340831726473
"1039",492,92,400,203.828814450512,175.356477873236
"1040",488,93,395,185.733718945332,172.754187320367
"1041",488,88,400,200.753467819596,179.594093488611
"1042",479,81,398,188.428318819031,177.657665918844
"1043",485,80,405,209.644126525812,178.5379528921
"1044",480,84,396,205.709939169072,175.343925727328
"1045",481,87,394,186.514567390231,171.561862887716
"1046",470,74,396,192.182862472791,180.214424601095
"1047",485,80,405,204.46061899281,175.690870513548
"1048",477,81,396,197.435658648374,174.144451836983
"1049",498,89,409,185.007148717521,182.742259065113
"1050",501,90,411,187.072704369955,177.130676081752
"1051",479,77,402,198.458752766332,173.959347350737
"1052",486,87,399,208.123965955643,177.281982908145
"1053",487,88,399,201.783322085509,175.322966147903
"1054",468,79,389,198.387858492662,178.681222512034
"1055",481,89,392,203.597595740287,176.253552268772
"1056",493,84,409,194.70719010791,178.042719606186
"1057",480,81,399,196.119398426117,172.618118252823
"1058",490,85,405,197.213482016342,178.485896027568
"1059",505,91,414,199.8369527401,178.009708528025
"1060",479,74,405,200.438036150385,181.910141902346
"1061",479,82,397,204.217017175298,175.078502375172
"1062",482,87,395,191.347033464773,179.164315842126
"1063",475,81,394,197.453445322527,171.991969243759
"1064",504,85,419,192.975098331588,176.255158070853
"1065",488,90,398,190.271913913949,173.574836587421
"1066",493,86,407,196.119003078014,173.035039696717
"1067",489,84,405,192.928364106958,173.577894855676
"1068",480,83,397,203.188450230951,174.544709857615
"1069",476,75,401,195.900394702883,172.80008800157
"1070",495,90,405,192.076257811412,181.895236941285
"1071",473,81,392,199.477276205372,166.541416615737
"1072",485,81,404,199.092183740567,175.002088875524
"1073",479,89,390,196.682708588105,179.302489692393
"1074",476,78,398,196.035857088544,171.363109378366
"1075",478,83,395,190.967828476486,172.971631335557
"1076",491,87,404,202.539817387869,179.467020089998
"1077",482,82,400,200.652464428676,175.096577253096
"1078",479,86,393,191.773203166348,179.786402137067
"1079",485,94,391,200.303351866628,170.698188393591
"1080",489,92,397,187.321233804212,173.745733707468
"1081",490,90,400,190.831464401089,170.416042229091
"1082",504,90,414,192.438068325306,179.537309079888
"1083",489,86,403,203.735789652549,176.862530164507
"1084",486,90,396,197.047113377146,180.117321351575
"1085",488,97,391,183.627094529587,177.487413559502
"1086",488,85,403,192.760743536421,177.519702568048
"1087",472,83,389,197.708996216958,174.766766801878
"1088",494,90,404,194.886344215849,175.386793368034
"1089",484,88,396,186.185596809907,177.653192464426
"1090",497,95,402,205.312124762603,180.770592263694
"1091",473,86,387,182.825154362816,173.172168561231
"1092",472,78,394,196.619760885776,174.497073642677
"1093",485,83,402,183.882593249649,176.204206754611
"1094",473,87,386,187.236116940532,177.962276237119
"1095",492,90,402,190.683474755492,187.554992398312
"1096",473,86,387,196.060961358321,181.578328595332
"1097",471,89,382,190.343346942881,175.98762177604
"1098",497,94,403,195.427680507101,185.079072739191
"1099",494,78,416,188.255650720944,177.565830586876
"1100",480,79,401,192.159761108943,178.290256499596
"1101",487,89,398,191.059500180646,178.817009728712
"1102",488,84,404,196.469688570999,183.16368100038
"1103",485,77,408,206.394784842329,178.308475507466
"1104",502,97,405,193.704779324166,177.371021556919
"1105",483,82,401,183.692267904014,176.600476902698
"1106",492,86,406,204.566669033319,186.926967826072
"1107",494,86,408,193.789410577509,178.449445777442
"1108",476,85,391,183.001317117956,182.106558001891
"1109",491,84,407,212.945723862263,179.143298774705
"1110",489,89,400,195.217298302916,177.678719086373
"1111",478,78,400,196.341187644075,181.916069624656
"1112",464,83,381,195.738944559956,183.522164286608
"1113",474,91,383,194.210271120846,186.946268485994
"1114",479,84,395,204.45462823074,167.921842039992
"1115",488,88,400,191.648416880426,181.95210874268
"1116",484,84,400,192.462229179727,177.811392005481
"1117",485,84,401,188.708342162672,170.055109811682
"1118",488,88,400,192.188771414628,174.11603333804
"1119",485,85,400,182.948154149661,177.197017844911
"1120",491,87,404,194.459047116882,182.095917054371
"1121",493,87,406,197.738833744019,173.620110251246
"1122",471,86,385,189.391220127273,174.116765834174
"1123",488,82,406,200.197368556144,176.152705588617
"1124",492,91,401,198.547381727352,180.249532216402
"1125",493,94,399,208.198395296207,175.331154672871
"1126",507,92,415,207.741146396992,178.516427530795
"1127",478,86,392,205.517478894236,176.877999796923
"1128",486,86,400,203.200575706391,179.977371789214
"1129",483,86,397,199.192772851807,180.080812044834
"1130",490,93,397,187.191569831664,170.370907578197
"1131",478,86,392,197.738073916179,176.862129319501
"1132",482,92,390,207.887419310554,176.167678974135
"1133",470,87,383,187.825213155804,169.742034666851
"1134",489,92,397,208.038817233193,174.130948612387
"1135",485,90,395,191.300379015019,179.923734099504
"1136",500,90,410,195.280988087938,176.220786187487
"1137",483,83,400,194.275178227486,179.538045714122
"1138",494,88,406,197.146655735734,174.798821844612
"1139",503,90,413,192.773281846696,173.701470381346
"1140",473,75,398,185.454168813536,178.484785930146
"1141",475,82,393,188.274064428864,176.417139002902
"1142",489,86,403,190.928797489702,174.753503889267
"1143",489,86,403,206.681442984154,178.632144220898
"1144",494,95,399,196.809571704961,178.215301284918
"1145",483,82,401,196.864741805386,174.349409593839
"1146",482,89,393,173.873952109381,178.75532853504
"1147",483,82,401,200.852449505937,171.74326878126
"1148",496,85,411,185.051777379338,174.464899070757
"1149",488,87,401,191.665600298624,174.866909932296
"1150",481,82,399,203.302512615989,170.836825422277
"1151",484,92,392,185.569965524962,174.8182183642
"1152",488,88,400,203.211972782988,178.313583280136
"1153",495,90,405,194.822403428288,171.049660693945
"1154",499,94,405,191.415685913461,173.327166723664
"1155",486,90,396,183.246588016961,180.811600608171
"1156",487,86,401,185.335373959592,180.843719940078
"1157",483,90,393,193.274453819315,179.558295272956
"1158",489,85,404,207.467529624268,174.066142929701
"1159",493,84,409,195.706858784105,176.543563314548
"1160",475,72,403,198.902104098649,180.81094660713
"1161",493,86,407,195.282972993482,178.604643310264
"1162",474,84,390,185.787975699699,176.4119036283
"1163",489,91,398,201.9020269396,176.147431373368
"1164",469,84,385,175.248072340365,178.514406812311
"1165",467,79,388,198.363758257184,175.142463035649
"1166",471,87,384,190.128473866229,184.113555310939
"1167",485,80,405,199.451526286156,177.562490119647
"1168",468,79,389,189.591190894612,170.850489830639
"1169",489,82,407,201.615203626779,175.399786691467
"1170",492,90,402,191.762250040307,177.845330683732
"1171",478,85,393,197.908458074391,174.034938882712
"1172",485,79,406,196.395565553511,180.207098350475
"1173",477,85,392,196.373732233373,178.818672622748
"1174",492,89,403,193.874051540803,178.768231003938
"1175",491,80,411,202.042093187856,176.255696422205
"1176",487,85,402,193.141900032792,177.452714093291
"1177",488,91,397,199.356817272895,176.122936419302
"1178",471,77,394,201.382142838915,173.636426248704
"1179",463,88,375,198.797298346257,168.395740024605
"1180",485,83,402,193.594020270846,171.089487621689
"1181",486,88,398,185.317142857714,176.359835532675
"1182",477,81,396,196.802982917518,177.913563708823
"1183",487,88,399,206.809414417582,173.317773487355
"1184",492,86,406,191.296959388779,181.157030289795
"1185",481,83,398,189.534586685429,172.726496911093
"1186",488,78,410,197.558810537499,183.149948481646
"1187",458,84,374,189.598017990749,179.598693404526
"1188",480,76,404,195.668560016011,179.351242901605
"1189",466,81,385,195.846468509202,182.606896995771
"1190",478,87,391,184.585425180263,178.148924807722
"1191",477,89,388,195.505388982137,181.898968341762
"1192",484,88,396,215.389820347248,173.583853238271
"1193",487,81,406,189.466459747739,178.811084077904
"1194",482,84,398,199.027617332473,179.500734332649
"1195",489,90,399,191.699580934194,172.215165826061
"1196",479,82,397,185.125746079359,183.272345656228
"1197",491,86,405,196.088720268007,175.628155078522
"1198",492,92,400,196.571227451203,179.583614918258
"1199",495,83,412,199.656532196919,181.617417124792
"1200",474,79,395,189.734727677667,177.818552275166
"1201",475,85,390,197.838661590127,175.647035042002
"1202",488,86,402,195.72931726329,174.354603834082
"1203",473,78,395,201.216974393478,178.12985525546
"1204",496,83,413,204.891404132147,178.175297821886
"1205",474,89,385,194.79858286287,177.222772832755
"1206",478,90,388,188.641753562289,176.821100475705
"1207",484,87,397,188.809606430148,175.96075439379
"1208",487,86,401,204.632370608186,177.565894306276
"1209",481,87,394,192.211164348897,176.960913887606
"1210",486,83,403,205.019526055772,177.487715851682
"1211",479,90,389,204.534171621881,175.607964899845
"1212",483,80,403,195.734246419639,177.586898354302
"1213",497,93,404,191.653610503572,175.438166713872
"1214",483,88,395,209.260567740892,175.397330516762
"1215",487,89,398,218.93898474998,174.945557422508
"1216",492,87,405,199.14919058021,181.192532703613
"1217",494,88,406,189.48144366471,176.135652034301
"1218",481,88,393,200.344911152582,176.396308618885
"1219",490,90,400,189.895960641838,178.734181629455
"1220",488,82,406,188.623879976195,177.132607532343
"1221",490,91,399,178.309392567295,177.394838690037
"1222",488,86,402,193.715712868864,174.88179143634
"1223",476,78,398,206.280528767254,175.323621386688
"1224",473,82,391,176.097532440256,174.438701091777
"1225",478,86,392,187.53622364584,179.16177042971
"1226",479,78,401,209.425200458932,170.47825819252
"1227",501,84,417,213.476243542738,180.715321641905
"1228",497,79,418,200.286788513861,176.640081906245
"1229",483,94,389,190.026575676595,179.705861452556
"1230",489,85,404,201.032454255881,176.555824794484
"1231",487,86,401,206.627209899624,177.880443460711
"1232",481,78,403,200.220243600302,177.137017719198
"1233",504,92,412,188.814916539621,169.305683298201
"1234",490,82,408,194.003207607849,181.906529511647
"1235",476,89,387,197.925403812469,173.042850582425
"1236",483,85,398,208.612567844242,179.662605403849
"1237",483,82,401,197.922176666333,176.735339208264
"1238",474,82,392,193.476748551147,180.021547412024
"1239",490,86,404,203.785238752222,174.990819396531
"1240",484,96,388,195.514554425675,173.832223937005
"1241",497,80,417,200.580353849876,170.878328579676
"1242",493,86,407,194.167034092408,178.420888177179
"1243",488,87,401,196.182871583276,175.446862100958
"1244",495,87,408,203.195309888657,167.852924802556
"1245",491,85,406,182.723864833364,180.433840841013
"1246",475,79,396,205.873872467298,181.14101675104
"1247",480,88,392,198.105123544892,180.946518676274
"1248",499,89,410,199.078983795596,184.666693524497
"1249",488,81,407,191.947450856614,179.47838605159
"1250",495,87,408,194.743626557324,177.225906454837
"1251",491,93,398,189.998955922774,171.216031179731
"1252",488,81,407,201.254167912785,175.668483726111
"1253",501,90,411,180.936365014449,177.702446673101
"1254",486,85,401,192.197311528386,177.761047632367
"1255",504,90,414,203.028536420796,179.230871158685
"1256",465,79,386,195.730847470093,170.038039218623
"1257",480,85,395,187.445913016546,173.89995569669
"1258",475,84,391,178.380894177065,175.950695484917
"1259",483,88,395,188.278542755704,176.147461084495
"1260",486,83,403,206.592056248232,179.951875994049
"1261",482,87,395,192.801063117029,172.224906248456
"1262",475,85,390,184.579122886756,177.722074859923
"1263",484,86,398,202.077452954975,180.894769379812
"1264",480,91,389,184.441601924358,172.990477507011
"1265",460,82,378,187.236235534631,176.451253986171
"1266",472,84,388,192.790609823551,175.322109847561
"1267",471,85,386,206.888316793163,177.011578691115
"1268",484,90,394,191.903248105287,170.131375078301
"1269",462,86,376,188.831725063214,172.38981691827
"1270",473,83,390,194.245122749655,177.399486955865
"1271",496,95,401,188.93948619329,179.070234948696
"1272",486,93,393,202.667682667722,184.957034894453
"1273",483,82,401,197.814451490052,177.131929270228
"1274",497,85,412,207.433312390701,176.48135247632
"1275",476,83,393,201.242418155464,175.772302835498
"1276",501,90,411,183.449795279052,175.180527979399
"1277",482,90,392,184.085344289965,166.848873822396
"1278",487,86,401,193.361006593738,176.351752408864
"1279",485,87,398,187.182666212703,171.734815233789
"1280",474,87,387,182.482659743247,175.899335511695
"1281",480,81,399,189.381337714477,178.388223873989
"1282",488,88,400,208.395358066423,177.091832358694
"1283",484,89,395,193.477738253665,178.570198729917
"1284",474,82,392,172.379214760409,182.873727947567
"1285",488,90,398,193.748840786936,176.726224358636
"1286",489,89,400,198.265892685364,181.019859949493
"1287",481,84,397,191.134937611213,171.715739764436
"1288",490,84,406,192.278940885227,167.198853804595
"1289",490,89,401,202.837789926079,178.423974598961
"1290",490,82,408,204.728868775713,180.655790112938
"1291",486,97,389,184.667789732066,178.701045872196
"1292",490,84,406,187.137985557964,175.832682836192
"1293",496,86,410,189.880791132325,180.062295472662
"1294",471,89,382,193.044322038167,174.752432284753
"1295",479,87,392,215.501454406377,178.268728821091
"1296",490,78,412,201.481522479153,178.432645847204
"1297",483,77,406,209.83306945217,175.490310086754
"1298",505,92,413,206.348300153989,171.411197173498
"1299",457,81,376,201.242950990375,170.113326945098
"1300",494,88,406,208.536749726024,179.818945836231
"1301",482,89,393,205.275433951009,178.808364975372
"1302",491,90,401,210.725033346624,179.27362955681
"1303",482,84,398,193.41253516789,174.956573108229
"1304",500,91,409,183.130200453754,176.323550623252
"1305",484,86,398,193.465314215175,181.222852905443
"1306",492,82,410,201.476928167771,181.326398796471
"1307",480,92,388,192.731426540885,186.422288488803
"1308",492,88,404,201.126800274039,174.265898592489
"1309",489,82,407,187.579493688624,172.225300576653
"1310",480,75,405,194.149273614979,180.261386329959
"1311",495,88,407,173.749536034116,177.600287478411
"1312",496,85,411,190.724704052557,178.294818602835
"1313",470,84,386,202.404496370646,183.739346378923
"1314",497,89,408,192.513515495136,180.09125605618
"1315",480,75,405,198.76700641107,172.765716415737
"1316",494,89,405,195.635404376056,171.480158161913
"1317",464,73,391,200.886721971787,182.067115474131
"1318",493,95,398,193.351944862469,172.000847677613
"1319",481,81,400,185.998283154227,179.460412185996
"1320",493,89,404,186.031460283109,172.106619877101
"1321",498,82,416,198.698532491594,174.208146037019
"1322",489,86,403,191.410892983426,179.093787295275
"1323",481,84,397,195.289310526764,181.239223339188
"1324",490,92,398,198.744497477852,176.805940368562
"1325",491,85,406,200.412256192732,174.851129233247
"1326",482,79,403,212.267681225719,180.048170985793
"1327",493,90,403,186.510249603727,178.542652804069
"1328",482,84,398,201.906938622863,175.892340895271
"1329",483,91,392,191.06560342149,172.586286625549
"1330",480,89,391,193.053773490614,182.155326552409
"1331",488,90,398,189.237525191078,178.07720274173
"1332",492,86,406,198.802144041145,181.409569885292
"1333",490,84,406,191.108211645149,169.326273322849
"1334",481,84,397,192.367740678528,178.648525496158
"1335",475,81,394,194.994392022575,170.209522037242
"1336",494,86,408,203.279520307588,174.719659083064
"1337",482,82,400,199.422348168912,180.311607752946
"1338",480,83,397,196.441536020912,173.098064334967
"1339",483,80,403,193.77278941716,175.233045183059
"1340",492,83,409,202.628700924264,180.190866954645
"1341",499,90,409,195.144523630091,176.369993089658
"1342",479,84,395,199.922987323069,175.918551001211
"1343",482,83,399,200.319374319907,169.554855854021
"1344",474,85,389,191.496150427688,184.058393946157
"1345",512,97,415,194.013767192377,176.389497976615
"1346",492,90,402,188.580353945244,183.552526277134
"1347",475,84,391,196.85846976964,178.592118938191
"1348",483,88,395,176.408839124884,173.678219093767
"1349",484,93,391,200.063893698225,180.773719535907
"1350",480,82,398,188.829936281971,175.764458869447
"1351",481,84,397,200.473331230532,177.239228256011
"1352",470,77,393,201.761265299573,188.168465799342
"1353",496,104,392,190.669193453186,179.302437057943
"1354",474,80,394,188.592855270116,173.59397841787
"1355",478,78,400,202.428972441198,178.359012961996
"1356",472,85,387,194.849455546345,186.725940145387
"1357",488,80,408,206.888661043066,178.018478357303
"1358",484,89,395,189.709212378454,180.393950137667
"1359",489,86,403,208.973898628807,177.326294628216
"1360",476,81,395,203.67021528196,174.199930272487
"1361",466,83,383,193.295754407231,174.75836026437
"1362",492,86,406,194.645768670431,182.651322157628
"1363",473,87,386,204.979697805441,175.022458201074
"1364",497,86,411,200.998408460541,174.849153054168
"1365",494,83,411,211.764003965231,178.814608354492
"1366",498,91,407,207.670153382966,172.782652966152
"1367",486,87,399,190.382233484869,174.436520118887
"1368",498,90,408,194.439247463387,172.279211749696
"1369",479,82,397,188.043172716728,177.990977363103
"1370",492,89,403,194.77882655643,174.213619531292
"1371",475,83,392,207.162655060684,172.051829566098
"1372",494,87,407,187.565633261459,180.368537676574
"1373",486,87,399,195.663786120434,169.817399878765
"1374",478,85,393,199.763751020287,177.178264003068
"1375",488,82,406,196.373889155083,174.244546932576
"1376",502,95,407,186.34409887918,175.907913981864
"1377",491,86,405,193.13701885988,177.436228760459
"1378",483,89,394,196.667634287854,179.109119388617
"1379",483,88,395,188.924745967286,178.505266782383
"1380",500,88,412,189.351288301668,173.378920120254
"1381",470,78,392,198.805414515349,175.907651236649
"1382",473,83,390,196.533907432525,170.836943587268
"1383",478,84,394,185.532357760839,176.924969260718
"1384",480,86,394,201.526061213609,177.105414664029
"1385",472,75,397,190.85292029298,168.974789679943
"1386",487,80,407,195.227679470172,176.205954634934
"1387",494,91,403,187.971206256793,174.793052666121
"1388",483,87,396,198.975961576297,184.360433386476
"1389",483,87,396,192.202165076735,173.342308996715
"1390",476,82,394,187.649184082772,174.072982989701
"1391",485,84,401,179.083751212709,178.646658173952
"1392",481,81,400,194.647461077519,174.934169071377
"1393",482,91,391,198.064791667493,173.806196131374
"1394",482,78,404,197.683641049992,175.694966305298
"1395",485,89,396,199.318131691553,172.289173632702
"1396",494,90,404,199.352604137925,182.618999475492
"1397",492,89,403,198.211302961325,177.556210663966
"1398",481,89,392,190.925794159375,172.22563976064
"1399",496,89,407,191.199479496482,177.974838605503
"1400",480,82,398,198.436211328037,170.172247789595
"1401",483,87,396,204.586189143752,179.296991259175
"1402",486,90,396,188.270880215129,183.291230546917
"1403",487,86,401,193.739701530661,176.75763564118
"1404",486,87,399,179.193905460005,179.467760966095
"1405",476,79,397,210.3462482933,171.733897973414
"1406",497,91,406,194.926646945036,171.167775804982
"1407",489,84,405,189.055041624513,171.770591753503
"1408",476,87,389,196.680221987005,174.812037761021
"1409",471,84,387,193.313485263481,179.951399066543
"1410",473,86,387,201.506718162964,175.517579602461
"1411",491,89,402,201.349772390306,176.022286213694
"1412",470,81,389,202.592447604182,171.558232778757
"1413",476,87,389,186.362773883417,176.088833765078
"1414",483,87,396,180.658197019739,177.984193061256
"1415",484,81,403,201.387971824647,173.1674785954
"1416",475,83,392,203.136547100749,170.726546301457
"1417",499,91,408,193.664258139821,176.293141049224
"1418",466,94,372,193.479952300617,179.666024120624
"1419",491,87,404,195.533088868163,177.492831618034
"1420",490,80,410,196.040840082824,175.962591761924
"1421",483,85,398,197.279723124112,178.587446994303
"1422",479,84,395,185.96019324015,179.769684100077
"1423",486,85,401,204.832957296794,176.094160562966
"1424",487,85,402,192.078201145954,180.646131316905
"1425",496,90,406,200.779815657266,175.819553261536
"1426",488,81,407,201.250905442741,172.380008041562
"1427",478,81,397,187.431350805672,172.688917348726
"1428",474,78,396,195.460054780421,172.920567713429
"1429",477,81,396,192.191930177386,182.255590439221
"1430",484,93,391,182.212104772181,180.656082166131
"1431",485,89,396,192.10162371574,176.256130886996
"1432",491,90,401,185.622042353367,175.839335667438
"1433",492,74,418,187.947209672639,175.297340367016
"1434",489,90,399,194.479613302326,176.216528190455
"1435",479,79,400,193.057539318615,174.688200803178
"1436",480,76,404,192.049351357726,178.447690008218
"1437",487,85,402,192.993361782318,180.051540268316
"1438",494,85,409,189.719583034991,173.165150123819
"1439",491,82,409,185.880004587174,173.695404005299
"1440",488,81,407,195.627855228261,176.812835758296
"1441",478,79,399,188.332732926861,176.79625135763
"1442",488,83,405,199.162119483312,180.821579235226
"1443",487,84,403,193.275858096014,175.524534527317
"1444",487,85,402,192.691348484142,174.663227291891
"1445",493,89,404,189.028101258215,173.932818423168
"1446",485,94,391,192.895774769421,176.503726054326
"1447",469,85,384,187.43380801195,177.102488264593
"1448",506,86,420,199.635011920798,177.441628384223
"1449",472,81,391,213.27685974014,182.425297986064
"1450",479,74,405,191.665398931058,180.043427627544
"1451",499,85,414,204.631153865998,175.96249957222
"1452",477,82,395,193.991805038569,173.345318030497
"1453",497,88,409,206.856949535478,180.575683843161
"1454",494,88,406,186.983266829665,175.654325239011
"1455",508,90,418,195.423615846591,168.362776514823
"1456",492,90,402,187.893622232988,176.257714391562
"1457",484,90,394,202.038746198956,175.460995790137
"1458",497,93,404,188.711256763233,170.704694721927
"1459",474,80,394,190.284045518018,181.063811933561
"1460",478,92,386,204.11358302348,168.513486571163
"1461",483,86,397,201.447290289876,185.254810766438
"1462",479,84,395,203.906739614864,175.410595724713
"1463",480,89,391,189.793717483715,182.23084334473
"1464",468,74,394,198.871239015231,177.340155192421
"1465",500,87,413,203.042844974359,175.45521641561
"1466",470,82,388,204.490236446322,174.173889660922
"1467",477,86,391,205.803390997692,175.35238981443
"1468",475,87,388,198.353743715813,173.200992425953
"1469",494,92,402,188.947094284199,166.15391011196
"1470",477,72,405,190.751322202321,179.947266378223
"1471",496,81,415,213.233593483203,173.004271935377
"1472",502,84,418,198.174515555233,175.065503908316
"1473",497,88,409,181.56876385011,180.778811876823
"1474",494,91,403,198.444816283283,176.149549828444
"1475",484,90,394,203.736683640147,176.374212434026
"1476",468,84,384,187.911701338024,180.453965381773
"1477",477,85,392,196.23702289083,177.08697223022
"1478",492,87,405,192.085048997453,175.736946647907
"1479",473,83,390,214.070581503735,172.861600025227
"1480",494,96,398,199.584986097654,184.633089542571
"1481",490,88,402,189.191057911513,182.691690616664
"1482",484,77,407,209.949346867507,182.936805762247
"1483",476,83,393,194.20976504107,171.942326567467
"1484",472,82,390,188.86796029043,173.616900043013
"1485",466,80,386,187.948091987084,178.439659091192
"1486",479,88,391,190.108990252869,178.140429828295
"1487",496,80,416,199.975963511789,171.094629876935
"1488",487,87,400,202.96626299503,173.356695408378
"1489",483,81,402,200.900787944295,179.677634005818
"1490",492,85,407,198.319598108398,183.423406981362
"1491",489,79,410,189.210263961086,176.313007540962
"1492",482,87,395,192.564837525553,177.953192846696
"1493",461,75,386,212.340989143272,168.342539058467
"1494",495,87,408,187.66535131984,177.094960897853
"1495",480,81,399,193.941165162996,175.212743015156
"1496",490,90,400,202.955689241711,172.313658635259
"1497",479,73,406,194.300645884538,177.265173888607
"1498",488,89,399,197.259514386799,177.300257257127
"1499",493,83,410,201.469880635933,178.294807629741
"1500",501,91,410,204.463005967943,176.994903563552
"1501",479,87,392,194.17657975006,181.4197290197
"1502",480,95,385,195.057420802459,176.270121442557
"1503",471,81,390,195.354368045883,174.947372550909
"1504",476,81,395,183.801941542624,178.374802596819
"1505",477,88,389,191.488827733857,182.87774933141
"1506",484,82,402,195.355442143776,175.297214719371
"1507",467,86,381,188.760787423348,171.885297701617
"1508",499,87,412,191.326149870576,178.440864852323
"1509",500,92,408,197.293297869073,172.853877230225
"1510",486,93,393,194.53180591611,177.147719422075
"1511",476,91,385,207.957919295437,175.155427461335
"1512",478,80,398,196.618649521866,175.323203472353
"1513",468,84,384,185.492137369138,168.497768136865
"1514",493,85,408,209.536868751184,177.700610259221
"1515",478,87,391,202.70317830653,180.602369134248
"1516",491,87,404,190.107129930005,176.438122531824
"1517",490,85,405,192.290683588917,175.751671759344
"1518",479,86,393,183.741851158247,172.129012148667
"1519",510,92,418,191.904908519486,182.866625022469
"1520",493,82,411,211.516559333225,179.024985186368
"1521",484,89,395,183.093244637984,175.741606237646
"1522",487,88,399,179.212079126373,171.709104276928
"1523",480,88,392,194.503500657325,172.892950119969
"1524",474,74,400,185.763471770085,179.381827822763
"1525",493,90,403,191.671039294799,178.123178938382
"1526",493,80,413,193.331182237811,175.688194982002
"1527",492,85,407,205.601452048798,172.605742712165
"1528",479,89,390,199.479655215205,171.344686141093
"1529",475,82,393,198.238297125772,178.05499148926
"1530",470,82,388,192.950462132138,173.957028613373
"1531",487,85,402,210.28581595137,175.795863273255
"1532",485,73,412,204.498115386858,178.183893151612
"1533",486,91,395,191.834734022007,170.388334297812
"1534",476,82,394,200.746297689919,180.905135532727
"1535",481,79,402,190.802843512125,171.815490055932
"1536",496,84,412,200.857950650444,172.484406099676
"1537",481,82,399,198.542474009729,179.424464287866
"1538",479,88,391,190.077871615789,180.97676451001
"1539",488,82,406,204.628351926891,181.706649329033
"1540",498,88,410,202.416703287458,177.622853838656
"1541",473,80,393,185.289598412919,178.058225724398
"1542",470,82,388,197.605423080447,175.948328424482
"1543",486,88,398,198.212130004805,176.140720504013
"1544",486,85,401,197.112213404156,174.19411838568
"1545",476,90,386,197.620610766369,169.975206038164
"1546",481,84,397,203.872781672335,180.508683177
"1547",488,90,398,190.784909079213,170.588088728778
"1548",486,84,402,197.484901207304,172.197627694958
"1549",484,84,400,191.335887732869,168.570436948179
"1550",473,84,389,188.741852349701,168.590410971471
"1551",482,83,399,202.62338462665,176.018796002507
"1552",476,77,399,202.376431619393,180.791783178121
"1553",471,83,388,199.621229378221,175.092197912668
"1554",486,89,397,197.285609524928,179.90507641073
"1555",476,84,392,187.071277410246,174.863536392857
"1556",462,82,380,200.938773148816,178.231512963227
"1557",494,78,416,208.308885089241,183.248475796854
"1558",500,92,408,186.058910322232,176.820371954321
"1559",478,83,395,192.488701572749,180.232721827828
"1560",499,85,414,197.783364945474,180.303748060956
"1561",491,86,405,188.864966926196,176.239941833509
"1562",465,93,372,205.229770141809,176.873820278327
"1563",481,91,390,187.836587899621,178.574508522794
"1564",496,93,403,201.170676744092,175.725239926507
"1565",485,88,397,193.053024369449,169.636729998647
"1566",484,93,391,191.929852697486,173.708520458741
"1567",497,89,408,169.915041222179,174.352999955389
"1568",486,85,401,197.293535694533,184.454465229641
"1569",485,84,401,193.395066528831,173.428114165239
"1570",481,88,393,195.543861940452,178.028752862453
"1571",495,80,415,196.383249962821,179.946623435571
"1572",487,84,403,192.747576453799,183.439532170493
"1573",478,83,395,182.586060354857,185.079463833483
"1574",493,90,403,185.18196508421,176.981068824964
"1575",475,83,392,191.526373638188,173.623838512735
"1576",468,79,389,194.909685801282,177.708447947593
"1577",482,82,400,198.33344027498,179.847450209176
"1578",494,96,398,192.359750338443,180.985054547437
"1579",480,74,406,197.611375905619,175.425869862607
"1580",481,86,395,185.930691876988,175.696996173259
"1581",489,88,401,186.126885696302,175.057019012021
"1582",485,90,395,189.490702137633,180.053159163993
"1583",486,91,395,190.166748094139,170.203968295439
"1584",477,80,397,203.566341279373,176.450632209918
"1585",488,92,396,185.643863060315,168.318255880336
"1586",477,81,396,195.140809927515,178.140554994712
"1587",495,89,406,191.645255021203,176.360325350347
"1588",483,90,393,187.252600641393,174.654147689127
"1589",507,90,417,189.985627212155,177.616243551622
"1590",478,86,392,192.892439813151,174.128048336145
"1591",471,89,382,190.677773192994,178.816704598282
"1592",465,71,394,213.407301377155,173.36314552909
"1593",477,76,401,193.515541411064,176.534286998209
"1594",476,84,392,195.242018668875,184.121070972192
"1595",452,80,372,193.264168057108,175.575031474006
"1596",490,84,406,180.230294782119,170.361316444894
"1597",485,87,398,202.729708839771,175.514721074267
"1598",485,85,400,198.535322543589,177.253283832566
"1599",486,89,397,199.256686702879,176.691267502693
"1600",494,86,408,191.917352830002,179.000249192742
"1601",471,77,394,203.965788543284,177.674069745317
"1602",478,90,388,194.505991838175,172.543563227059
"1603",491,87,404,198.896104542681,177.357602084966
"1604",475,87,388,191.537633569832,167.31669715599
"1605",485,84,401,206.099547053345,179.554530389238
"1606",479,85,394,189.92463328431,178.416137210525
"1607",488,87,401,193.222232784041,179.329235890857
"1608",475,85,390,176.964840615511,179.447190164433
"1609",472,86,386,189.543141352329,171.174337827333
"1610",489,82,407,201.367990080581,177.681556995308
"1611",475,78,397,186.473024258854,177.461030937911
"1612",466,73,393,189.458560524495,178.795215993679
"1613",496,91,405,194.910431403341,178.658889220949
"1614",494,89,405,203.231421851205,168.655905711766
"1615",483,87,396,194.92674998883,175.579713445305
"1616",474,84,390,199.01485673378,175.546042802163
"1617",483,90,393,192.99416003431,178.74952195168
"1618",483,85,398,184.249634898305,177.590932773111
"1619",482,81,401,184.188956839068,177.497797862733
"1620",502,92,410,203.276535265851,172.671529121861
"1621",480,81,399,200.907594938846,174.121298207063
"1622",473,91,382,184.823149425372,178.529950665606
"1623",490,91,399,205.332005772201,171.462518038112
"1624",503,89,414,200.344269619452,181.709185873654
"1625",483,83,400,198.780160002153,175.361074663863
"1626",490,101,389,189.955871979189,177.479666564809
"1627",491,86,405,179.403042531672,172.970723620298
"1628",477,80,397,195.519109822528,175.822595387765
"1629",499,86,413,195.903997332634,175.997777490494
"1630",477,84,393,206.277019295526,171.161402564954
"1631",470,80,390,192.719950647634,175.868378912339
"1632",497,84,413,181.173732495163,167.999853031274
"1633",486,94,392,192.245824974677,183.914359924144
"1634",488,83,405,207.765272900673,179.304968248346
"1635",488,91,397,204.749826219817,176.136385170834
"1636",472,84,388,196.049480561054,177.048834262583
"1637",504,86,418,192.049301065351,174.717456294672
"1638",490,91,399,196.282660842027,182.096328244439
"1639",480,91,389,194.057013999383,179.937025078473
"1640",493,95,398,198.145390267672,176.995662831943
"1641",493,85,408,203.360632037174,176.009412850633
"1642",486,87,399,199.553954234263,173.904449859455
"1643",480,81,399,199.122521000956,174.399823624404
"1644",476,87,389,202.191796935886,177.327285504122
"1645",476,82,394,191.586041378914,177.605935056038
"1646",490,86,404,184.972063678173,175.489747618003
"1647",505,82,423,196.617929359622,181.196665341542
"1648",484,85,399,199.451334056208,172.611892205765
"1649",463,73,390,203.466274265968,175.07773913344
"1650",480,85,395,192.857412954379,174.586709987671
"1651",486,80,406,194.751052641995,177.382643716272
"1652",498,87,411,193.655406932024,178.64206710207
"1653",488,84,404,197.501101440016,174.611166718535
"1654",487,81,406,194.91022686547,182.260391620151
"1655",483,89,394,200.929453370261,179.785712022556
"1656",469,81,388,199.527078593902,165.397187720373
"1657",481,79,402,194.251064245304,180.794829626545
"1658",482,78,404,198.04404979534,178.355233631409
"1659",498,88,410,180.211012984354,176.983474819408
"1660",493,88,405,189.429413804112,175.565457685757
"1661",470,88,382,205.129404887655,179.978193086234
"1662",475,79,396,181.626336223075,172.609144341669
"1663",490,86,404,189.165231497163,175.178930953129
"1664",492,80,412,196.43091681142,170.617629662183
"1665",489,90,399,180.420133889,173.420846225366
"1666",503,92,411,200.125157607448,176.28708182656
"1667",493,87,406,197.292973066849,178.843756082944
"1668",505,92,413,197.650534952486,181.785691835823
"1669",485,82,403,179.404692435073,177.453975860769
"1670",484,80,404,193.215791023327,171.126805812299
"1671",484,84,400,207.979945733103,184.838886757218
"1672",504,92,412,167.530850506274,177.592718129262
"1673",481,87,394,201.244856383905,177.531928101904
"1674",474,77,397,201.530609178269,176.350574533958
"1675",470,85,385,198.660941629887,172.220300575048
"1676",487,90,397,199.666770493932,178.442286859045
"1677",485,79,406,209.249885078263,179.970509735947
"1678",472,83,389,189.158292735972,173.361149153599
"1679",493,85,408,198.655525602685,173.39140312628
"1680",480,77,403,204.414384686479,176.643817837123
"1681",498,83,415,196.991267721736,187.021659665642
"1682",488,92,396,197.499065812496,170.931658410577
"1683",468,81,387,186.707504471513,183.630908110407
"1684",478,84,394,199.619059568113,178.883533305151
"1685",473,76,397,195.734617360301,174.571980114213
"1686",490,84,406,190.266043016256,172.363001086973
"1687",493,88,405,185.526101027281,176.972598225365
"1688",482,82,400,191.128177653793,173.766232984469
"1689",498,97,401,204.977631250806,175.710580269329
"1690",478,87,391,208.179891049463,173.533039412885
"1691",484,78,406,195.906591788959,173.984717448174
"1692",486,82,404,196.785725364981,174.677159339979
"1693",487,94,393,194.425409536568,173.821334414685
"1694",477,88,389,201.529674945651,177.122658899072
"1695",499,80,419,199.382672823862,171.31862170757
"1696",468,82,386,198.208042170892,174.168727165408
"1697",486,82,404,183.382683362542,178.30284143969
"1698",491,89,402,190.755253529231,181.651126685857
"1699",488,85,403,193.672069130934,168.155080282921
"1700",480,90,390,189.843685720441,176.876694271266
"1701",491,84,407,197.318250627343,171.940791706193
"1702",469,86,383,194.859658165161,177.801767090757
"1703",480,83,397,184.440539141925,177.388350234532
"1704",464,85,379,183.942925079747,173.054780041439
"1705",497,86,411,198.133365297599,175.97124019806
"1706",484,81,403,191.860530711105,173.201774375643
"1707",482,84,398,199.225370882042,176.476242114356
"1708",486,84,402,196.488209468834,179.370263798425
"1709",496,88,408,196.057033895214,177.250873014649
"1710",479,88,391,193.462679222795,173.323061198112
"1711",471,85,386,192.509672919373,179.483321072283
"1712",478,86,392,190.909036938261,175.38005474074
"1713",482,86,396,206.85567270833,171.577287745515
"1714",483,77,406,186.405401943183,179.997613193865
"1715",481,88,393,198.98596560591,174.676775737993
"1716",496,87,409,207.037808264849,174.357213524505
"1717",503,90,413,186.354008428814,174.50333804516
"1718",477,86,391,207.277451429869,180.240442608086
"1719",505,84,421,180.299085076065,174.601657628541
"1720",481,86,395,196.680888405928,178.946397358683
"1721",462,85,377,179.821060828194,176.032530617583
"1722",482,87,395,196.438067364384,172.532516077097
"1723",500,88,412,193.459869059156,176.369627574099
"1724",476,87,389,189.650905074956,179.562281557384
"1725",501,92,409,180.81417462038,175.880416332277
"1726",488,84,404,196.694644870245,177.114538625054
"1727",473,87,386,195.904270136327,174.682874248958
"1728",474,79,395,197.678577151495,177.362076367428
"1729",491,84,407,199.990127551506,170.649432220753
"1730",484,78,406,197.70422294489,176.118525737294
"1731",482,85,397,202.386100608474,173.053466248091
"1732",495,87,408,185.749063105396,180.6749709331
"1733",487,83,404,186.926442324043,178.447994275265
"1734",487,84,403,203.075256680556,177.946681078609
"1735",481,84,397,191.51361105882,177.374514737
"1736",473,92,381,184.115627660514,176.401142454512
"1737",477,88,389,194.671596445679,174.538460502079
"1738",481,97,384,200.86063474841,184.341996080759
"1739",485,82,403,195.077383753468,180.814167825929
"1740",488,83,405,191.778489326042,174.297133772377
"1741",486,96,390,192.658335346891,171.605715833344
"1742",489,88,401,191.76555839825,178.452679351422
"1743",488,86,402,189.399624133391,171.930017425836
"1744",474,75,399,193.403949504505,169.529226369348
"1745",481,77,404,196.731363234479,178.799229278882
"1746",491,85,406,202.566853561454,172.256428653366
"1747",478,96,382,194.173064467959,177.032769079344
"1748",486,94,392,187.81859226206,177.201206904976
"1749",479,84,395,195.160117185896,178.794815680751
"1750",484,83,401,187.457136932088,170.962797319628
"1751",491,85,406,195.39278827529,179.409924756347
"1752",492,88,404,201.790370449442,175.001104959078
"1753",480,88,392,201.275749183994,185.166188869873
"1754",505,91,414,199.348732526985,175.045369195659
"1755",492,90,402,187.550090353069,177.354697388938
"1756",478,82,396,194.032463089552,181.400354890509
"1757",481,86,395,198.938228375299,176.646599754287
"1758",471,89,382,193.753237460056,171.461581719783
"1759",484,84,400,200.651716520603,176.902574894129
"1760",478,85,393,185.308650149952,175.592514020577
"1761",476,88,388,199.541009077232,174.266736412258
"1762",478,87,391,204.381534202886,180.471818254821
"1763",489,90,399,205.284757212311,178.044774567616
"1764",478,83,395,210.456825270722,175.080591450253
"1765",471,86,385,191.113911914237,171.30786698739
"1766",470,85,385,196.390247629922,173.547170484725
"1767",480,89,391,197.243066837825,177.894252705307
"1768",484,78,406,188.587871917028,178.670025638098
"1769",461,79,382,201.325850773856,171.849495392113
"1770",488,87,401,193.646753330588,171.720871569499
"1771",478,88,390,185.005104613977,177.573004930344
"1772",493,75,418,193.068089526449,177.419643799925
"1773",489,86,403,209.015294267173,177.37443137259
"1774",498,82,416,197.861053646158,176.270030163852
"1775",489,87,402,202.815514552747,173.201032667674
"1776",482,83,399,196.058755432143,175.10298473941
"1777",493,88,405,188.168733970275,171.640370990169
"1778",494,83,411,195.045149002945,175.982404643394
"1779",482,85,397,187.53964824175,176.517449901602
"1780",489,84,405,195.125920396205,179.316610282608
"1781",500,93,407,174.21507169839,181.951820987834
"1782",494,81,413,206.229935630881,178.317373782105
"1783",493,85,408,187.952345416404,180.609041588673
"1784",491,81,410,190.011697225581,181.273124228444
"1785",491,93,398,185.458586929946,178.088525300389
"1786",480,74,406,198.876909406631,175.662473598665
"1787",499,91,408,205.448100978683,176.548950939086
"1788",484,78,406,190.589052168204,180.061360493382
"1789",474,79,395,187.400467844465,175.343096632743
"1790",495,90,405,192.858865496815,173.805345361826
"1791",477,84,393,193.597022693985,178.308317490439
"1792",472,84,388,186.098484935171,172.118645465728
"1793",499,84,415,191.655806875185,177.204314056885
"1794",493,96,397,192.342054696672,173.569602656695
"1795",500,94,406,206.90319596333,176.304260480697
"1796",484,83,401,189.317303223981,172.382007889528
"1797",480,93,387,203.204874150216,172.191125766795
"1798",466,80,386,198.251996318591,175.692075337122
"1799",485,82,403,195.632188400794,179.368848352451
"1800",485,83,402,190.765609418187,172.517054341552
"1801",506,87,419,186.327106479119,174.812631571849
"1802",481,88,393,191.170903831033,180.367524119169
"1803",479,83,396,182.557105506197,174.954342783423
"1804",490,94,396,188.627341134517,172.872114750291
"1805",493,81,412,208.671696948288,175.7621674517
"1806",495,88,407,191.034304593808,179.079074271635
"1807",475,84,391,201.052646022736,176.516565020069
"1808",473,80,393,190.562689325697,176.247708715437
"1809",495,92,403,192.824295658359,176.140600304707
"1810",472,83,389,203.066492602654,171.296069190184
"1811",499,84,415,188.37362635909,174.373435807843
"1812",488,88,400,192.604910070589,184.403413875298
"1813",481,80,401,207.76390741103,176.882613362226
"1814",488,84,404,185.088299456184,176.545651501976
"1815",477,86,391,189.45397409534,178.07445688099
"1816",493,75,418,203.275294877164,180.443631438355
"1817",472,84,388,188.158402481175,172.435865734845
"1818",479,88,391,190.758272254155,172.166175965288
"1819",486,86,400,195.369550119962,171.934017718779
"1820",490,87,403,190.281359544706,174.523077904851
"1821",468,87,381,204.42054008261,174.51794526062
"1822",487,85,402,192.616545045365,177.590052970387
"1823",481,82,399,193.361327469357,181.808067926175
"1824",497,83,414,174.366302781542,179.411627147352
"1825",490,84,406,192.928709864341,181.40031565201
"1826",484,75,409,202.108233064098,174.696784271862
"1827",489,82,407,186.314958589004,178.551297289927
"1828",483,90,393,195.64891389364,176.807386171151
"1829",483,76,407,189.109758419028,177.17529748481
"1830",487,90,397,210.318159589104,180.6065061401
"1831",496,79,417,195.889986929073,170.402892949788
"1832",484,86,398,182.247694672154,172.845097430434
"1833",479,81,398,199.027134018706,175.489210762346
"1834",486,86,400,189.425165935067,174.287373741591
"1835",488,87,401,182.699069686758,171.700341901667
"1836",487,87,400,190.242025211004,178.637317681262
"1837",492,87,405,192.035629767362,175.773065507523
"1838",476,82,394,206.575845178457,182.217525755217
"1839",483,80,403,198.406877287843,179.509729512112
"1840",481,84,397,196.199426388112,169.757751785563
"1841",472,81,391,192.481995210109,176.368446800324
"1842",495,88,407,198.242465064371,179.497670315947
"1843",492,87,405,199.555599792252,176.894034922471
"1844",474,78,396,203.862493441559,177.212403210782
"1845",485,90,395,192.142296913326,177.429868105566
"1846",477,81,396,198.134712938942,182.388305454925
"1847",482,82,400,184.620930834322,173.640010944317
"1848",474,78,396,192.898156021284,176.145896846555
"1849",492,87,405,197.611022115852,172.038540745055
"1850",498,84,414,187.550672925813,183.770007955746
"1851",479,86,393,181.028564255177,176.454170054424
"1852",481,77,404,195.072713227387,171.790176865573
"1853",489,89,400,208.000949984754,175.434048510307
"1854",507,86,421,195.937287162632,176.251675248816
"1855",502,86,416,194.898678924832,174.621282766432
"1856",466,88,378,195.613786643954,174.554839025985
"1857",486,80,406,205.292171961839,180.443170761478
"1858",487,87,400,193.366392044816,179.170660946368
"1859",494,91,403,193.673803544582,179.257149335202
"1860",493,90,403,196.394161240254,176.516756631896
"1861",487,88,399,201.940630238018,173.637545027966
"1862",474,79,395,195.67902960657,168.500191435552
"1863",503,88,415,195.24399354844,175.640129461869
"1864",485,86,399,192.15258738854,181.935166155326
"1865",481,85,396,200.478575979609,171.258996112196
"1866",460,81,379,197.831664554027,179.441419348764
"1867",476,84,392,192.353522128597,177.303338438009
"1868",471,83,388,203.961102485302,169.776893390645
"1869",492,93,399,182.614133156212,176.243418795698
"1870",497,85,412,186.842468722835,172.017642270901
"1871",495,84,411,207.138870848511,175.944180018287
"1872",479,91,388,197.992875055781,181.903516195348
"1873",478,81,397,189.98295042796,175.159958540185
"1874",480,78,402,198.243277632646,175.949499490176
"1875",484,87,397,187.359357953924,177.055490747537
"1876",482,89,393,199.720656277493,181.480803573426
"1877",484,91,393,182.459804880414,180.754813218024
"1878",473,87,386,186.938521682267,173.784529154538
"1879",493,95,398,189.027805350586,178.706662336685
"1880",480,80,400,194.782129388452,174.284853815078
"1881",485,89,396,205.57482830882,179.944227052075
"1882",474,84,390,202.251574268408,177.705727711231
"1883",479,90,389,187.346311137287,169.84460215062
"1884",488,94,394,200.192464547874,181.159441669288
"1885",476,90,386,198.424383963611,172.919114508361
"1886",490,92,398,199.134025411009,180.450465548117
"1887",476,93,383,194.038487548826,179.382920429156
"1888",496,91,405,177.491066448385,174.897411745494
"1889",485,90,395,180.376905993755,176.568569586945
"1890",476,80,396,201.391819326711,172.484108666281
"1891",491,85,406,202.968571232627,174.602470372721
"1892",475,84,391,204.062240788512,168.896965164832
"1893",477,81,396,213.848272362545,183.639466147038
"1894",482,90,392,176.535089495332,174.381030166014
"1895",495,85,410,200.427520914012,175.064841696383
"1896",480,83,397,187.606942489682,175.493921071725
"1897",490,84,406,193.93186680604,173.6841967576
"1898",481,86,395,208.73447669226,177.433345017072
"1899",494,84,410,194.965802243948,180.024863977262
"1900",511,90,421,198.528932200472,172.116494264414
"1901",465,78,387,200.327354770147,171.35771935574
"1902",474,83,391,200.104147331953,178.29477143584
"1903",487,86,401,198.530927348487,168.795400499225
"1904",493,89,404,216.779474722849,170.650965115501
"1905",482,88,394,186.474444610218,179.204781144754
"1906",481,89,392,192.009784312912,178.023510198644
"1907",496,90,406,189.306002904826,176.731464800593
"1908",494,92,402,191.831889144774,173.614370895983
"1909",475,89,386,194.394592793492,174.239701549716
"1910",470,81,389,198.305695585516,175.96728076974
"1911",469,78,391,187.769080253726,178.52049603746
"1912",496,86,410,195.605046403728,178.449857803616
"1913",498,87,411,201.166315713949,175.189793655555
"1914",484,84,400,184.055227845823,173.682341877385
"1915",490,87,403,196.109455027389,175.917899573562
"1916",494,90,404,198.083922603625,174.108388759998
"1917",497,91,406,202.856583120275,176.069430522187
"1918",495,86,409,200.395666724197,180.025163045234
"1919",478,85,393,188.053055774938,174.373032706792
"1920",492,80,412,194.152821463979,182.512315171481
"1921",480,83,397,190.944988613553,176.662536213637
"1922",498,88,410,201.917594305537,171.396042582918
"1923",491,96,395,188.991942444895,175.29532607871
"1924",497,84,413,194.708691778654,182.469020896443
"1925",490,79,411,193.315958834338,174.798070797606
"1926",489,91,398,192.960507860965,174.689808010987
"1927",485,92,393,200.539634738619,174.639960995004
"1928",478,80,398,193.194334883164,173.161870497338
"1929",474,91,383,190.658899659837,176.245813215637
"1930",490,87,403,184.490938031591,180.081792054755
"1931",492,85,407,197.779902695823,177.98457268401
"1932",487,94,393,190.575303291925,176.437539830935
"1933",469,81,388,209.768776621926,175.908049029154
"1934",488,84,404,193.301363685488,174.586883548466
"1935",479,93,386,197.941708177592,170.915595252829
"1936",492,90,402,205.873506557326,175.39581118603
"1937",484,89,395,179.041545109105,173.088600714484
"1938",499,90,409,200.552479708286,175.46331816921
"1939",491,85,406,199.087271119165,181.7979627378
"1940",477,83,394,186.493046584781,175.195411255152
"1941",482,80,402,199.084845407314,182.28805871037
"1942",485,86,399,199.263350098881,173.940139661689
"1943",473,94,379,194.658045674631,174.334222952259
"1944",475,86,389,196.244957841637,174.351499482922
"1945",489,82,407,194.179238174337,176.342828578688
"1946",481,88,393,213.854264092809,175.131941829468
"1947",497,89,408,193.750844196098,172.093850474995
"1948",487,95,392,194.735909401963,181.061777392591
"1949",479,93,386,187.986293147682,169.540120999466
"1950",470,81,389,207.445169950145,172.989983207679
"1951",485,88,397,197.599355774701,178.715751888706
"1952",489,84,405,213.303623819789,177.338672075663
"1953",478,88,390,205.200696253719,181.597644561061
"1954",493,89,404,194.519656722631,181.325481485398
"1955",478,90,388,192.70808068592,173.968887850201
"1956",490,90,400,187.33422177715,178.078422758001
"1957",493,90,403,205.694042197052,179.951236829935
"1958",503,93,410,199.6906420272,176.359482562471
"1959",470,79,391,191.302112355681,179.860789877256
"1960",480,96,384,190.865299710201,175.046303516158
"1961",481,78,403,208.748773422929,172.135270293367
"1962",507,81,426,202.422900269385,175.499077096128
"1963",489,91,398,200.028744884918,175.446147550087
"1964",498,90,408,196.731139194718,173.022102634711
"1965",505,89,416,191.450363087406,174.677128008357
"1966",475,92,383,193.303321973397,178.397713007145
"1967",468,84,384,191.812594338524,167.801585126446
"1968",482,85,397,195.708121474278,174.469146829056
"1969",477,88,389,192.394911687809,178.276412230391
"1970",512,86,426,189.097732884887,175.670619655883
"1971",473,76,397,199.529781191844,178.21750628123
"1972",501,85,416,198.697253619656,177.322676332596
"1973",507,85,422,201.847779235324,179.41748952493
"1974",464,77,387,185.884536799927,173.802083174422
"1975",493,91,402,178.995557019443,175.492447313883
"1976",492,84,408,189.726548229349,182.499706925851
"1977",475,77,398,187.893632876624,179.292146647312
"1978",482,81,401,204.083716090431,177.717226719554
"1979",466,75,391,197.588887333515,173.26355681175
"1980",487,84,403,199.203040221025,181.000857823872
"1981",476,82,394,200.209603845741,178.502466623099
"1982",485,84,401,196.439470969177,180.790960105453
"1983",467,76,391,202.150741954186,185.085375509882
"1984",477,81,396,205.339743493377,183.791918516367
"1985",475,77,398,194.240147613278,174.775458111831
"1986",493,88,405,202.604041195917,174.464848092002
"1987",487,90,397,181.211409432277,175.765543678147
"1988",484,80,404,198.752420177757,176.056348549877
"1989",497,91,406,215.398375350014,174.688856027803
"1990",478,81,397,203.005399501579,173.232361766243
"1991",487,78,409,195.423126436257,174.949675421355
"1992",481,92,389,191.509172532032,177.268562707567
"1993",478,80,398,198.930600153818,174.112674501597
"1994",498,85,413,191.390312074611,176.844994962113
"1995",482,87,395,183.470943587712,176.365305450015
"1996",474,80,394,197.602328457797,181.139469868508
"1997",472,81,391,185.52643913237,173.66641875325
"1998",497,81,416,205.718935252275,179.700209298953
"1999",477,88,389,192.963457480217,183.296327847887
"2000",481,91,390,193.975664835621,175.550662284064
"2001",490,86,404,195.047200148197,178.968758022086
"2002",497,89,408,191.330321862147,180.405871782706
"2003",484,81,403,190.228144469992,173.587644403024
"2004",486,83,403,205.776078680383,175.21770790614
"2005",475,83,392,225.934899668187,177.17178595682
"2006",473,82,391,197.761983140906,168.570477078755
"2007",498,93,405,197.251863271604,176.621916316839
"2008",486,88,398,196.719415248989,179.891017872716
"2009",485,89,396,190.659297579761,178.485019605665
"2010",503,97,406,184.721141045627,177.093889908084
"2011",501,96,405,186.700142162744,175.363397570963
"2012",481,84,397,206.243013065547,175.748395573152
"2013",482,80,402,199.786012571338,177.073038688438
"2014",471,77,394,200.216470894278,180.177033609429
"2015",465,78,387,194.569694308698,178.099653880182
"2016",489,92,397,191.070694205271,177.905442116907
"2017",489,81,408,202.898617536643,185.81970867144
"2018",483,80,403,202.585603490615,177.553468539208
"2019",479,92,387,190.327226569981,177.66406791582
"2020",494,84,410,193.760753978248,176.226322683504
"2021",479,77,402,197.736147866974,182.364056103865
"2022",485,88,397,193.226354442232,179.929117312144
"2023",475,87,388,206.884139349744,181.894820631447
"2024",487,87,400,195.288546272351,174.888741414686
"2025",484,86,398,204.0722900136,182.81613205121
"2026",493,98,395,188.092989022489,178.744464279419
"2027",481,87,394,195.807650287517,180.061909420359
"2028",508,84,424,192.463070003854,179.311150041788
"2029",483,90,393,202.529949741384,179.430109463657
"2030",511,91,420,202.917151787461,169.818744370788
"2031",469,85,384,194.706122872052,176.734718952831
"2032",493,86,407,182.755997044525,174.946761951187
"2033",469,85,384,198.686409149328,179.872986468292
"2034",485,89,396,198.98045509049,175.414425110244
"2035",477,82,395,194.578722948297,177.903333149752
"2036",497,94,403,190.75159156847,177.127102324052
"2037",447,82,365,197.371123229036,176.192346948676
"2038",494,83,411,202.191772670788,172.714004333409
"2039",478,83,395,202.073069453767,185.156000047288
"2040",500,88,412,202.39500883858,177.405463992941
"2041",474,90,384,194.82562985477,178.313274589285
"2042",469,83,386,202.021418582404,174.87754922762
"2043",495,91,404,196.863265072865,173.365325815305
"2044",492,91,401,204.784680556816,172.19661031431
"2045",472,78,394,193.670418256027,176.406192432796
"2046",487,91,396,180.062990302267,179.967259925839
"2047",493,88,405,193.41208881104,177.334159753534
"2048",470,81,389,195.908141361445,176.465331633527
"2049",483,85,398,189.158983370593,173.152458580879
"2050",477,88,389,195.687326727341,180.61125381524
"2051",469,78,391,196.433056553309,184.328475373629
"2052",471,85,386,200.21374523699,174.388690130557
"2053",495,94,401,178.430227393982,176.733764420323
"2054",465,82,383,203.958985256385,173.858200155226
"2055",482,82,400,215.845048042273,177.922721030232
"2056",482,83,399,191.853800397717,180.234079608894
"2057",489,91,398,200.132134114046,177.436060211344
"2058",472,80,392,196.499030281029,175.716492879687
"2059",479,83,396,202.295825214106,181.537944709994
"2060",479,86,393,199.808821035462,173.731315030542
"2061",478,83,395,188.879073345632,175.015633868169
"2062",503,85,418,185.313630266237,178.798850940538
"2063",499,91,408,208.295675508739,172.220307378854
"2064",491,87,404,188.445844038204,175.670910459775
"2065",469,78,391,195.73262671206,173.668161737567
"2066",498,90,408,192.157601663699,175.190222461429
"2067",489,80,409,190.985037461548,178.49898399503
"2068",477,88,389,182.800012935193,178.905147592236
"2069",490,84,406,189.004411842139,179.434054660039
"2070",484,92,392,179.239408235071,176.768927401773
"2071",479,85,394,194.81545509142,170.880878799166
"2072",480,87,393,184.108581402409,181.703439348851
"2073",491,77,414,211.037086259994,182.288794514186
"2074",482,91,391,203.252158116666,173.914625133156
"2075",475,81,394,203.876676745526,184.855486102938
"2076",494,87,407,195.596967707942,177.744009378677
"2077",478,84,394,190.688656801404,177.404820281782
"2078",473,83,390,201.092009022412,173.898923791562
"2079",468,95,373,199.099452073123,173.510455471907
"2080",492,89,403,200.576891427895,172.841113464026
"2081",481,86,395,205.275121785704,175.597280366289
"2082",490,82,408,189.413362285346,175.959304217139
"2083",479,83,396,212.017727673384,180.048679648211
"2084",484,93,391,192.877339836321,178.17500606411
"2085",484,87,397,198.171775592986,174.869012017632
"2086",480,87,393,203.94616134609,178.061579865586
"2087",489,80,409,196.033864774053,178.29725524714
"2088",479,89,390,191.512314576228,178.551967660366
"2089",492,83,409,194.607371351835,174.853882300021
"2090",497,80,417,192.661880721724,175.213404121847
"2091",474,79,395,175.048007676358,183.61057887039
"2092",479,81,398,193.596868288951,172.646513699304
"2093",523,94,429,192.550708747663,178.139764239748
"2094",500,86,414,200.476342009398,179.267549359194
"2095",476,83,393,189.504861727661,175.508717902541
"2096",503,94,409,200.458441625994,176.15840890353
"2097",477,77,400,193.583998711064,177.312764291444
"2098",463,83,380,201.416286957809,176.759428741959
"2099",470,75,395,187.298552761736,174.01238445208
"2100",494,88,406,192.136453065428,177.521249141741
"2101",494,85,409,195.138953965752,183.451535600154
"2102",490,85,405,190.9531802609,178.76517049457
"2103",491,96,395,191.537914857832,173.561659803668
"2104",497,92,405,203.531671687118,184.675040140511
"2105",475,83,392,203.119176579258,179.966188377609
"2106",492,85,407,200.717316013757,176.915183046692
"2107",482,78,404,202.466715488008,172.900571309085
"2108",483,87,396,195.16077199622,169.31564579101
"2109",475,78,397,198.536534180669,175.379926761755
"2110",504,82,422,202.967157757602,175.478092366388
"2111",475,83,392,194.63753983258,182.255498473278
"2112",488,87,401,197.048049190885,178.572888865197
"2113",492,94,398,202.353561105161,181.685249974424
"2114",470,79,391,192.029939436508,176.197261949168
"2115",504,93,411,198.401524600253,181.097632441792
"2116",503,83,420,201.196307673313,178.880559514716
"2117",494,93,401,195.237547394743,176.769242118384
"2118",495,81,414,196.126634816043,174.788681769199
"2119",484,92,392,201.96752041048,179.887070545834
"2120",510,91,419,201.128385442182,177.742523053192
"2121",478,88,390,196.243131180695,176.146521185761
"2122",485,91,394,203.282388751941,179.432689090572
"2123",482,87,395,188.547203150758,184.102734515133
"2124",473,80,393,205.547413097618,177.906677554516
"2125",513,91,422,199.929549569856,175.757594498653
"2126",474,81,393,196.152176769246,174.466898741381
"2127",485,79,406,195.321800384557,177.10523515612
"2128",503,86,417,199.648328460718,176.313785958191
"2129",493,91,402,183.786356339402,176.680752882347
"2130",480,85,395,194.380774663686,184.854821018087
"2131",491,91,400,193.528802290494,169.628814512341
"2132",482,83,399,202.321127205909,171.635743821325
"2133",486,87,399,200.132297016775,173.066023057655
"2134",496,86,410,200.843558214667,174.973949168589
"2135",479,87,392,201.350637001661,178.351457262806
"2136",496,83,413,207.394544996701,176.976363259801
"2137",481,78,403,199.846023211653,175.684209301678
"2138",480,87,393,196.127442004568,183.281169895917
"2139",480,79,401,209.903404459924,173.062050798507
"2140",483,84,399,188.706669462886,177.932467541239
"2141",490,102,388,189.220786895002,181.55613226378
"2142",482,78,404,203.95430239665,173.910684933634
"2143",474,89,385,195.585591151724,177.622606895319
"2144",491,83,408,187.424864146959,178.606605004258
"2145",490,85,405,194.61731391943,173.445206807337
"2146",476,89,387,191.59413942575,180.524547200807
"2147",475,83,392,191.834394938556,180.215622444903
"2148",477,87,390,195.802072468012,176.943033882994
"2149",480,84,396,198.299281970636,184.570021058063
"2150",485,82,403,184.086193345356,175.914391279447
"2151",487,94,393,190.045853853259,174.896805489579
"2152",482,86,396,209.632451398628,183.005709355152
"2153",496,84,412,201.958522300365,176.57588634497
"2154",475,83,392,196.156800267006,174.50128291173
"2155",478,87,391,195.835944697024,173.047647431622
"2156",484,84,400,193.909612141637,177.400522344387
"2157",491,85,406,201.0656783734,182.813622310791
"2158",483,90,393,189.060011229602,176.452195566872
"2159",482,85,397,201.56692927425,177.285735719098
"2160",485,80,405,193.850633672661,179.469466726013
"2161",491,89,402,202.234573767155,177.203639385545
"2162",481,85,396,198.004419222739,182.800025820432
"2163",490,90,400,201.977697530156,180.961669746949
"2164",484,84,400,177.966980669555,178.797210102382
"2165",489,83,406,198.789876688204,172.276781938557
"2166",481,81,400,188.826112094828,176.95626110723
"2167",489,92,397,191.41732762563,174.742490650529
"2168",478,83,395,197.316338408695,177.759760568173
"2169",485,88,397,197.797492568318,174.344989126606
"2170",481,81,400,192.316310912918,179.192859405433
"2171",493,94,399,195.248105211833,175.935465912802
"2172",485,86,399,202.578251855982,171.923418752648
"2173",467,80,387,198.173841054933,178.001815395993
"2174",493,86,407,194.735700800825,171.78448799276
"2175",491,93,398,196.424585205578,179.325273188644
"2176",496,83,413,211.481162275762,175.448308414727
"2177",478,82,396,195.354194429658,178.135740439582
"2178",465,84,381,192.266491945636,176.837374661701
"2179",496,76,420,194.395867692769,171.794121210499
"2180",460,76,384,196.352109837063,174.506451560331
"2181",492,87,405,187.529085480785,178.722965460184
"2182",502,92,410,199.81126140848,175.776949407299
"2183",485,86,399,185.276052512492,175.050504027535
"2184",474,81,393,195.817791583773,172.46811050499
"2185",482,80,402,207.728881176069,176.694118683882
"2186",491,90,401,194.214671282221,170.105742318222
"2187",481,82,399,198.771634978899,171.781706173567
"2188",475,79,396,189.424847856966,175.985661856309
"2189",484,78,406,197.087586564099,177.722679046896
"2190",495,93,402,201.696740584282,171.510289802209
"2191",476,90,386,200.254457632839,180.743858616286
"2192",480,90,390,199.065209255824,178.168227477257
"2193",479,89,390,207.38045339677,177.357749689064
"2194",489,78,411,193.25861214605,178.025448398491
"2195",486,90,396,203.996274389362,178.012614090225
"2196",479,94,385,198.779373052173,179.846462867961
"2197",487,87,400,184.95125151156,181.130034391338
"2198",499,87,412,209.821730869724,170.013767218296
"2199",492,80,412,199.766736398773,180.65497873111
"2200",488,84,404,188.362408052076,175.074140492097
"2201",481,90,391,193.400102800563,176.562844333206
"2202",501,86,415,202.194545046147,175.318178472048
"2203",493,88,405,210.870582620033,176.501566633835
"2204",486,87,399,196.555552330648,181.489605701997
"2205",509,84,425,197.488648264534,179.260817369164
"2206",456,76,380,190.56372831074,174.904299165119
"2207",481,89,392,183.115746521761,176.536049337714
"2208",488,80,408,195.399117986304,176.834509247725
"2209",477,90,387,199.141684125146,165.691757858048
"2210",483,89,394,191.916828282214,175.705847029096
"2211",492,90,402,182.401575421607,175.915733175535
"2212",479,87,392,197.878198114703,180.512412015869
"2213",485,86,399,210.153628462223,176.968076574761
"2214",494,95,399,188.504194093834,176.389527169404
"2215",483,85,398,192.935234174211,178.578443282143
"2216",490,78,412,205.160987793129,176.766269871121
"2217",481,82,399,191.256861754762,178.650915493321
"2218",476,85,391,197.113055679421,178.333108012334
"2219",467,82,385,189.87730621061,178.920382514962
"2220",462,86,376,206.650054845828,170.697884869091
"2221",484,88,396,190.489949017222,178.055499790079
"2222",480,75,405,204.564575519176,174.932221330927
"2223",488,83,405,208.48529701769,177.537375466133
"2224",485,91,394,193.463645739381,176.07352468334
"2225",481,87,394,203.201481618747,170.031504311808
"2226",498,93,405,186.408532626063,178.608339366741
"2227",498,90,408,206.895581941133,174.940891880248
"2228",491,92,399,196.106895276527,165.366926466145
"2229",477,81,396,201.389813479028,176.597639903958
"2230",499,92,407,193.276939924602,175.378116247667
"2231",473,88,385,194.467884567385,176.263697856432
"2232",502,88,414,180.642486965031,175.209915994438
"2233",476,78,398,198.093482928054,173.244371709875
"2234",498,91,407,198.138472986244,180.353494551788
"2235",484,87,397,198.96334180579,176.981440181059
"2236",501,85,416,188.735319347772,175.39442168799
"2237",491,86,405,190.758898289028,169.786802588194
"2238",472,83,389,211.194260252671,181.687985128013
"2239",487,81,406,194.19335792785,176.195683877672
"2240",485,90,395,187.937209611787,177.230009248872
"2241",473,78,395,203.128259483411,177.567081957929
"2242",487,92,395,187.533339605078,177.111559338151
"2243",490,79,411,194.934645541615,173.877991438735
"2244",479,84,395,194.181890889124,176.104114476386
"2245",492,90,402,199.987895078037,172.744896119559
"2246",465,77,388,196.906804716239,180.901269163099
"2247",483,89,394,195.061365156421,175.067587674389
"2248",482,88,394,198.866816390734,174.343904834477
"2249",497,88,409,182.100563146666,178.371796684617
"2250",498,86,412,191.704005264715,183.775350063002
"2251",473,89,384,187.92884375354,181.651665361234
"2252",473,86,387,189.558916036427,176.150317472704
"2253",495,88,407,187.175974919268,178.117797078057
"2254",491,80,411,187.166906297148,171.014385286131
"2255",485,83,402,189.449208135286,176.741165534712
"2256",477,83,394,198.656606630478,180.832175405305
"2257",479,86,393,177.433049621668,184.53583975614
"2258",493,79,414,194.566747428984,172.180729234404
"2259",485,80,405,195.740017789869,170.495092173451
"2260",466,81,385,183.110651082188,179.09055026887
"2261",493,97,396,186.622201665785,180.712901411748
"2262",480,79,401,202.169983267973,178.320951069507
"2263",483,89,394,191.363944368989,177.50182939715
"2264",493,93,400,184.978207689664,178.680440621005
"2265",512,88,424,196.932841892453,180.517186473022
"2266",487,82,405,186.0908167206,180.907813999273
"2267",482,90,392,197.701854215768,180.933812503509
"2268",480,84,396,201.313038226361,173.59874346751
"2269",506,95,411,202.417045071135,171.20289192982
"2270",489,88,401,191.499481407352,180.452468144302
"2271",495,79,416,201.319309477903,174.135399888908
"2272",484,91,393,197.581247385795,182.955974336058
"2273",503,84,419,181.903675367365,175.37568252634
"2274",481,89,392,200.584167422357,179.20884949747
"2275",496,85,411,200.890545177271,173.408072179826
"2276",489,89,400,189.681686665344,173.82117788905
"2277",479,79,400,187.03403113211,174.683763830142
"2278",499,86,413,202.805341099364,174.007801421539
"2279",492,82,410,192.54690418711,173.346372005142
"2280",475,78,397,193.780825281036,170.376419401837
"2281",493,90,403,182.042736517986,174.643230589568
"2282",481,95,386,188.084268969629,174.443122070028
"2283",480,79,401,199.215993865767,177.911391996802
"2284",485,83,402,193.682392311823,178.161754681905
"2285",498,87,411,201.622123435419,170.916052861131
"2286",486,84,402,190.959493532843,177.910947552692
"2287",488,83,405,201.134106110068,177.755412263893
"2288",478,84,394,197.626986572182,176.493248131194
"2289",471,85,386,206.154147306689,170.620636448759
"2290",502,91,411,185.26240751927,170.042926573408
"2291",485,88,397,199.667779906051,181.893764901462
"2292",500,89,411,198.121852078454,185.653837973962
"2293",494,85,409,201.189737161565,175.238375845554
"2294",473,76,397,192.16900222041,179.984980053366
"2295",480,82,398,195.994190699806,177.253955543372
"2296",478,89,389,197.803373768459,181.940467362126
"2297",484,82,402,194.366810993956,177.513446384517
"2298",475,90,385,199.878814474597,178.700220024828
"2299",481,86,395,200.112077235442,176.626180204316
"2300",496,88,408,201.59752777527,178.2814767698
"2301",474,90,384,201.094128340988,178.530926379554
"2302",476,79,397,194.818614906163,175.313228951026
"2303",485,89,396,182.844868911824,168.069968714343
"2304",481,86,395,189.360984419149,180.327341006682
"2305",487,88,399,182.71856145331,167.961912539222
"2306",469,90,379,186.880397308593,175.94204799981
"2307",485,90,395,198.724576158378,177.512628827977
"2308",481,78,403,186.354333629865,168.939131592664
"2309",482,82,400,177.664272335343,183.83281678258
"2310",495,92,403,187.208449310884,181.553789810638
"2311",474,83,391,190.026995606221,170.57356653052
"2312",480,87,393,195.38806605531,167.721462905573
"2313",468,84,384,189.462126149686,176.386160336968
"2314",472,86,386,195.366025509667,178.122143070958
"2315",484,81,403,203.930925490178,180.891624745448
"2316",495,92,403,194.544999522289,177.273496063999
"2317",482,86,396,193.154123220231,181.960546986994
"2318",473,80,393,193.18352469694,177.582401253684
"2319",478,80,398,199.340382389436,173.851557277606
"2320",484,96,388,199.785796822437,176.721475454946
"2321",471,87,384,200.600266886004,180.803291782966
"2322",474,90,384,201.222213744918,178.911617126264
"2323",474,84,390,198.79172556738,177.830548478274
"2324",488,87,401,189.096495425929,177.944607591957
"2325",500,87,413,196.83168579604,183.061698880114
"2326",478,87,391,198.039206971688,183.955660461587
"2327",475,87,388,197.240949542673,176.951999623242
"2328",492,87,405,191.870459586827,175.390769995393
"2329",506,91,415,189.540371176679,174.577806997681
"2330",486,87,399,194.127646595313,175.012745959484
"2331",490,81,409,189.81810035588,177.088549958002
"2332",501,88,413,196.753711076889,178.217679318345
"2333",491,85,406,191.52495279674,179.048962925768
"2334",485,81,404,200.716741922622,171.005371351679
"2335",487,83,404,204.919334736736,171.604815793279
"2336",496,86,410,201.220779003101,177.871255567124
"2337",476,82,394,197.221450114816,177.163494584009
"2338",483,84,399,196.979782804499,180.76750542735
"2339",487,88,399,190.42090377298,169.777547765641
"2340",485,85,400,182.925336854123,174.040468244003
"2341",480,92,388,192.15712342694,173.590212261145
"2342",485,92,393,206.216066669741,177.633000619872
"2343",483,86,397,197.027953044484,183.117367758698
"2344",478,91,387,193.696909881135,172.789593181362
"2345",457,88,369,192.673793037611,178.012559993599
"2346",503,90,413,208.424157619434,176.865507244082
"2347",476,86,390,192.838560936116,176.239933185452
"2348",472,83,389,204.277024240568,184.248776760858
"2349",479,84,395,198.473503958371,181.548019092459
"2350",481,81,400,199.234821099895,180.265728096468
"2351",494,81,413,196.994136393793,177.559920824288
"2352",492,89,403,198.295603938817,181.587201497461
"2353",482,89,393,194.508562832619,175.268805917708
"2354",487,89,398,198.998825561169,173.634733080023
"2355",486,79,407,192.410987055005,176.532646473634
"2356",504,87,417,192.62793868487,175.132919641586
"2357",490,88,402,200.938168668549,182.404253296162
"2358",485,87,398,199.243128909544,178.157773604549
"2359",476,82,394,186.494852571249,179.132962729314
"2360",478,92,386,199.905676636359,175.153090701489
"2361",494,87,407,198.484870879891,172.806884823042
"2362",478,87,391,193.565488755809,179.657452607572
"2363",473,90,383,199.103782502264,176.715432213823
"2364",481,88,393,186.833684699359,175.111875334626
"2365",485,84,401,200.25258720832,178.643072923237
"2366",486,79,407,190.901169017702,177.881456651917
"2367",480,82,398,192.930868605469,175.304986098846
"2368",489,89,400,203.030668962113,179.660575289402
"2369",495,77,418,193.91016291291,175.943935803119
"2370",486,85,401,209.907481831066,170.937068700339
"2371",467,80,387,204.008412805389,182.15880180883
"2372",480,89,391,193.086400029736,177.932019086118
"2373",464,94,370,197.198193247897,172.037508139405
"2374",488,89,399,193.192508158048,178.889342514416
"2375",500,88,412,186.322993671251,176.185636832773
"2376",493,83,410,188.901708671948,171.459415836465
"2377",490,91,399,193.688036043206,177.929162253693
"2378",470,86,384,177.205184879916,174.415935263838
"2379",478,73,405,195.132156467856,174.526676920378
"2380",488,86,402,193.162955800311,179.085680237877
"2381",497,90,407,189.40611571232,182.816152998768
"2382",484,86,398,198.122296764942,175.474346291363
"2383",483,85,398,195.340702079584,179.051559241178
"2384",474,74,400,197.668893522681,174.683679618635
"2385",495,87,408,202.502675933482,179.98490572198
"2386",504,86,418,201.00189867965,174.33284825112
"2387",486,98,388,203.633351719914,182.424575431114
"2388",504,85,419,205.072730527398,174.73122998322
"2389",470,75,395,208.188194455191,179.987930823103
"2390",478,89,389,200.621523782502,174.20449699598
"2391",467,81,386,196.800244828166,177.376911360114
"2392",501,89,412,197.19607815002,177.292857364236
"2393",501,90,411,189.269833277843,176.532577037625
"2394",480,85,395,187.779367155013,176.778107458015
"2395",480,86,394,200.496910882665,182.47827484125
"2396",475,81,394,196.190521085036,178.130066625304
"2397",488,85,403,197.207868198946,179.115415921036
"2398",482,79,403,200.189119889801,171.705580673217
"2399",480,79,401,201.804835513956,177.431456271872
"2400",484,86,398,189.152161234738,182.739725371612
"2401",484,79,405,193.942174277096,180.743071561387
"2402",496,91,405,195.403030772679,178.717477981751
"2403",477,84,393,189.517846720699,177.042827600301
"2404",479,82,397,188.289910527674,174.816845298112
"2405",470,81,389,199.08676327284,171.291301202207
"2406",479,72,407,198.216231743872,168.769580083218
"2407",509,88,421,194.060132771089,174.568447986648
"2408",477,86,391,198.732061130302,174.084111049638
"2409",492,87,405,200.350753381341,180.519683614874
"2410",476,88,388,188.917554314991,180.016324505744
"2411",469,88,381,200.582429607406,175.80832715911
"2412",486,83,403,188.80291754642,174.512061353555
"2413",498,96,402,190.777520862181,179.318267393738
"2414",484,89,395,183.714654615883,171.011059870171
"2415",485,91,394,193.375892531941,181.981170673581
"2416",479,86,393,184.547424442698,179.584901581178
"2417",468,82,386,204.980887155941,176.606804383543
"2418",467,80,387,197.780490129359,173.881080990152
"2419",471,84,387,187.532931246289,175.74191201117
"2420",493,88,405,196.051892774041,176.036269013891
"2421",488,83,405,186.739768544664,176.675952380949
"2422",484,82,402,187.203744999941,175.818969725819
"2423",468,83,385,199.740964219212,171.439732893316
"2424",471,78,393,192.518710654017,169.578076431963
"2425",480,86,394,205.51239261917,176.647285678173
"2426",488,87,401,194.741790691286,177.847849265074
"2427",500,88,412,198.021453549737,174.478415565009
"2428",490,81,409,190.601102376349,170.138481868657
"2429",477,85,392,185.217493450226,175.505769872434
"2430",468,80,388,173.75615561009,175.24672065416
"2431",475,78,397,204.157671946334,176.027771085898
"2432",496,94,402,198.958578302366,178.92111318172
"2433",483,78,405,195.528538086702,178.756483701574
"2434",484,86,398,193.591002435186,169.939770336007
"2435",472,82,390,200.389495598041,176.000841276594
"2436",474,81,393,185.186347853981,181.625728551053
"2437",487,83,404,205.589821402525,176.925263284955
"2438",497,88,409,195.63381015429,181.163385190707
"2439",484,91,393,203.721178903508,179.322026133821
"2440",499,90,409,193.27522708011,180.13656667073
"2441",465,83,382,198.210147028488,180.261623908016
"2442",480,77,403,198.627382106385,175.505654505312
"2443",476,75,401,205.239802796156,174.878689795108
"2444",484,91,393,181.339006249176,184.730395448794
"2445",478,84,394,200.652236010248,175.08553513391
"2446",481,79,402,200.927554261177,170.933950537902
"2447",487,79,408,181.875034545834,175.372972926341
"2448",492,80,412,187.205995587774,183.070604529985
"2449",487,91,396,180.754887999288,181.787071109661
"2450",490,89,401,196.415810853541,182.841914919763
"2451",487,88,399,186.952912638041,175.879488850333
"2452",494,83,411,198.988763831798,180.93252666857
"2453",482,81,401,192.756777498318,174.886686697235
"2454",482,83,399,186.739825905526,172.478187231235
"2455",492,86,406,191.952262372415,184.053667271307
"2456",489,82,407,192.26696696588,185.049545893805
"2457",479,90,389,200.616262165015,180.007956087702
"2458",501,87,414,195.949844568081,180.537898556158
"2459",481,87,394,203.976006897781,178.123063284545
"2460",491,88,403,200.765167281307,174.312670300018
"2461",474,80,394,186.086789846044,174.665337704795
"2462",485,93,392,197.49454183519,172.851425636577
"2463",501,87,414,197.281399506184,176.081361562591
"2464",462,80,382,210.485591853154,172.856561132758
"2465",475,80,395,191.521402159505,178.68017454361
"2466",478,87,391,189.379743975655,180.218158944393
"2467",483,82,401,200.456299194916,177.21942310681
"2468",487,88,399,195.100625157915,179.320004411747
"2469",484,94,390,195.315534936109,173.269825091488
"2470",494,87,407,187.386044469129,177.473741063581
"2471",474,83,391,205.578842894623,173.600977329844
"2472",495,92,403,186.305751872616,172.250626379198
"2473",479,82,397,206.943423152207,178.605471185477
"2474",487,78,409,201.375858987642,172.720328007101
"2475",494,87,407,203.327989379246,175.854308968723
"2476",486,73,413,189.388974317268,171.535997580254
"2477",492,86,406,199.542429237442,182.146666914869
"2478",486,81,405,201.920380191332,177.177691448288
"2479",492,82,410,206.024708225784,181.11991034831
"2480",508,92,416,189.926067490952,178.570559745901
"2481",489,86,403,196.024022439298,180.474189203568
"2482",505,86,419,195.508077710942,169.845008611835
"2483",475,81,394,182.12537252697,180.774538708631
"2484",485,91,394,177.024266871532,176.938320922322
"2485",486,87,399,193.283596703487,175.007638374528
"2486",495,87,408,195.623307682587,183.77665150313
"2487",476,89,387,194.793357551784,172.866945554059
"2488",492,93,399,193.204483287641,180.783372551435
"2489",474,81,393,202.915402326067,175.009359002144
"2490",499,87,412,192.392136964403,176.971505043926
"2491",491,78,413,187.812683136738,177.146379987916
"2492",473,82,391,178.502518201464,176.192096674575
"2493",465,81,384,196.154232177362,176.506221759141
"2494",477,85,392,208.032299220817,176.66925981687
"2495",479,80,399,178.170283277237,174.514762791585
"2496",481,96,385,194.781862749595,175.935918752666
"2497",488,84,404,189.702921500194,177.135865054737
"2498",497,91,406,200.914606474526,170.908046792387
"2499",472,87,385,184.433092786419,176.278899712678
"2500",490,89,401,189.970535388038,175.25036074835
"2501",500,89,411,203.262704190793,176.436138487734
"2502",484,88,396,198.595011222123,183.156806717542
"2503",477,80,397,191.677519769235,180.500023869304
"2504",497,91,406,198.414182549285,186.697671702799
"2505",498,80,418,202.201626489326,179.380892742518
"2506",492,89,403,192.066539083321,176.775734725312
"2507",497,88,409,193.675028835865,171.945086809762
"2508",488,88,400,193.334228302018,180.311619804548
"2509",478,86,392,186.798894455873,180.906194134574
"2510",493,88,405,183.723474382682,180.2565268698
"2511",474,83,391,198.391913152754,174.518990784523
"2512",480,83,397,206.693467081705,177.392385005618
"2513",479,86,393,196.554701572549,179.517212888937
"2514",474,86,388,192.79790208986,176.468762319
"2515",485,88,397,183.26895137817,175.326654155213
"2516",478,83,395,204.556733901508,173.841487873525
"2517",477,94,383,191.489103068819,176.187498872155
"2518",481,83,398,190.00323042404,181.345893595962
"2519",483,81,402,194.214715350916,180.558088970336
"2520",472,75,397,210.716809676733,176.458946270335
"2521",491,91,400,197.941844504998,175.268564999597
"2522",489,86,403,214.598284357824,177.747399139217
"2523",484,82,402,199.00980169672,181.172961637458
"2524",487,84,403,195.320155512167,175.258349841342
"2525",489,96,393,190.620763105392,175.233635105728
"2526",481,95,386,196.352491216755,179.545912393094
"2527",495,90,405,193.433961952923,180.171740047665
"2528",493,93,400,194.225790296292,174.695392372289
"2529",477,85,392,192.681791681599,182.279173190825
"2530",471,78,393,185.309531287103,179.645685600135
"2531",477,94,383,191.621359697635,181.760525521806
"2532",504,92,412,188.737629033082,175.143000778451
"2533",477,82,395,196.264274687587,172.465663638263
"2534",478,88,390,202.689245291998,174.690048280951
"2535",466,80,386,197.346990081903,173.139837085794
"2536",493,86,407,211.651155262342,180.221725790491
"2537",465,83,382,205.49594714354,174.786232536384
"2538",497,85,412,198.000357632312,175.124853781653
"2539",482,91,391,199.570743426353,177.70464683484
"2540",486,89,397,186.361226755179,182.944050429311
"2541",511,91,420,190.12587857825,180.465256025974
"2542",485,77,408,196.81178494197,174.671567315448
"2543",476,84,392,185.907754716427,178.109607786585
"2544",486,84,402,197.769156506802,185.284990344373
"2545",464,79,385,189.712950401341,175.956120683712
"2546",478,84,394,199.459506696563,173.326928682747
"2547",484,82,402,190.520041897966,178.317064676279
"2548",496,92,404,187.577487572684,176.998218112099
"2549",486,88,398,183.092040295276,171.575986625883
"2550",485,81,404,200.185646715088,179.338315109074
"2551",484,86,398,196.229845098275,172.355323363139
"2552",477,78,399,196.133633733786,172.886431905115
"2553",483,92,391,187.843254625724,181.762940520108
"2554",472,85,387,188.438056239308,180.542949826369
"2555",492,87,405,189.380263197745,179.579245064332
"2556",479,86,393,204.220509091196,173.190159994641
"2557",497,91,406,193.449930834252,182.305037166696
"2558",474,82,392,198.901473365988,175.185235081914
"2559",482,90,392,198.539315225757,176.191636659601
"2560",495,92,403,190.572347177186,174.578655959419
"2561",474,88,386,205.151267539656,174.853221415231
"2562",479,83,396,203.872999659481,174.871929547761
"2563",495,85,410,199.278531233155,174.937391754697
"2564",497,85,412,198.028426530753,172.58726485455
"2565",484,86,398,203.126171879078,177.366780095365
"2566",492,87,405,195.58052495542,177.8512776118
"2567",482,77,405,198.399018365121,171.265009402154
"2568",490,86,404,196.61933581446,179.591179561245
"2569",498,90,408,197.403579085455,180.983004833229
"2570",476,85,391,193.278471375216,173.178867952731
"2571",491,85,406,202.132752038953,182.47547465186
"2572",468,81,387,199.081840050303,174.877450470825
"2573",488,88,400,180.405452247704,177.644374468803
"2574",471,84,387,191.880941503412,168.383815786991
"2575",484,85,399,185.809427494291,177.867428285754
"2576",486,90,396,181.481406180415,178.644419386824
"2577",488,88,400,190.648391222715,178.522923600323
"2578",482,87,395,187.745086366316,177.565072029544
"2579",473,84,389,184.390687036594,177.622690027036
"2580",469,87,382,187.580760278201,177.5889621964
"2581",480,91,389,188.866601166903,174.70959215782
"2582",493,83,410,201.245546181102,171.914966400869
"2583",490,87,403,194.744103205443,178.034993023777
"2584",488,90,398,183.329490054064,176.037628321638
"2585",458,79,379,199.282788100202,171.66724907993
"2586",481,89,392,195.035940521382,173.41456683582
"2587",498,92,406,187.604794203908,172.456204794226
"2588",481,76,405,207.898336209662,180.037942031129
"2589",491,88,403,191.891861892375,177.228728818591
"2590",469,80,389,184.914910058155,167.857249994808
"2591",475,86,389,200.383299531126,174.060806683924
"2592",485,90,395,191.494850722844,177.317116255207
"2593",468,84,384,197.132237935099,177.927666473057
"2594",488,79,409,195.332678951877,174.339051580068
"2595",499,95,404,194.883146502763,180.328788598663
"2596",475,82,393,198.331116864815,175.418482651069
"2597",495,89,406,191.622702086522,180.032305537835
"2598",489,87,402,184.3121771796,171.993545149723
"2599",493,92,401,201.947439729892,171.215919739381
"2600",477,83,394,192.411124123442,180.901820119977
"2601",478,82,396,198.415393302179,178.464332397554
"2602",477,93,384,188.846265161219,174.414855203186
"2603",483,90,393,191.648676637743,175.444314866171
"2604",479,91,388,197.754512604238,180.612780378104
"2605",489,80,409,208.836843428086,179.202444251723
"2606",472,84,388,186.157581688634,178.030456768015
"2607",479,86,393,205.797338728223,180.51622682944
"2608",494,91,403,202.646319943971,177.991863226136
"2609",484,86,398,183.353428050705,181.384010637879
"2610",491,78,413,182.996860459903,179.037810626838
"2611",486,82,404,208.829860844518,176.103510817834
"2612",468,88,380,182.990779005866,174.559566890293
"2613",494,82,412,198.057689872642,170.531502802702
"2614",463,84,379,190.359190157646,175.796608481893
"2615",485,88,397,191.45120617352,175.472317158424
"2616",492,86,406,192.668968750152,177.523400685535
"2617",475,78,397,192.651762803189,176.812250473224
"2618",491,88,403,195.625507206512,173.324564622724
"2619",497,86,411,187.005906559178,173.579897888424
"2620",477,82,395,187.848455258739,176.788245086367
"2621",496,83,413,196.771354354266,177.075213462153
"2622",491,91,400,188.844854278487,176.287645865586
"2623",482,81,401,195.216692245105,181.975609519076
"2624",480,81,399,195.147427989581,175.64749623304
"2625",481,84,397,200.817048091819,178.358693016539
"2626",476,87,389,188.770024386809,173.250676221266
"2627",485,84,401,199.568484340922,178.701218936085
"2628",480,88,392,193.945517601148,175.801408317859
"2629",484,89,395,189.96212144936,181.451780351732
"2630",481,81,400,198.708173208113,170.552825050632
"2631",487,83,404,201.718558091588,176.032401190301
"2632",483,83,400,193.791894969832,179.390131579187
"2633",485,85,400,208.247922575934,173.944612806865
"2634",483,79,404,193.434758957637,173.239647796529
"2635",470,83,387,191.903617132725,175.875651677698
"2636",472,70,402,208.759573058486,174.629134921544
"2637",517,96,421,188.698622627026,177.104892865868
"2638",473,82,391,195.806349640823,174.456173149468
"2639",496,92,404,179.049715729393,177.067456693919
"2640",481,90,391,203.119914548373,180.538910231534
"2641",479,85,394,196.662136996302,180.465958879733
"2642",491,79,412,196.791085008613,176.854818095078
"2643",482,77,405,200.289291739005,170.640193770373
"2644",487,89,398,191.321018960899,177.339510246638
"2645",487,79,408,192.844707082584,173.113525326013
"2646",482,84,398,192.537339748064,175.51883388925
"2647",480,87,393,180.009237484579,175.708897376258
"2648",477,84,393,187.76622830892,176.027710537803
"2649",473,77,396,194.644886374434,174.607130857049
"2650",468,87,381,188.862806553409,174.155297733935
"2651",468,82,386,201.086841021626,183.277238838734
"2652",486,75,411,200.962892683832,175.806801698824
"2653",507,96,411,195.963881902832,180.450506886619
"2654",481,88,393,198.652257436534,173.920393604823
"2655",487,90,397,194.109492998174,175.415609360528
"2656",470,83,387,203.266407469989,176.887924917794
"2657",470,82,388,198.970821634228,180.191598184909
"2658",492,88,404,189.907587883247,170.487737056075
"2659",488,88,400,201.77238453392,174.0398062077
"2660",489,79,410,190.898670669014,175.765314753693
"2661",475,93,382,191.465270465411,164.595761368785
"2662",476,90,386,184.693341466956,183.560010335838
"2663",485,90,395,197.626472483422,183.106470903201
"2664",481,94,387,176.670539838612,176.000054944805
"2665",473,88,385,199.039735335171,182.447490459133
"2666",483,87,396,183.413354085028,175.755792870033
"2667",482,85,397,185.916059039943,176.426585249986
"2668",479,88,391,195.717578539786,176.310940651367
"2669",488,88,400,181.128984296954,181.016245957114
"2670",476,81,395,196.626122647083,174.492238820201
"2671",497,83,414,209.057035545263,179.494543398224
"2672",481,83,398,195.912156598803,173.821747288571
"2673",477,91,386,196.607800868684,181.658059770003
"2674",477,76,401,194.255527083942,178.4814121789
"2675",482,86,396,201.271096223351,173.882015631995
"2676",476,78,398,205.944334665023,173.734080182504
"2677",481,89,392,199.399755544702,176.769498492612
"2678",481,86,395,210.37990595386,178.058694128908
"2679",483,87,396,201.080438763094,171.371700799015
"2680",488,85,403,199.92392969579,177.704745164323
"2681",472,83,389,184.654445356035,176.705075747425
"2682",485,86,399,200.451303112569,181.119757711701
"2683",487,85,402,196.557441774004,181.845734867031
"2684",493,86,407,188.510675497062,175.939497972694
"2685",487,82,405,195.824131796601,182.304531256973
"2686",504,92,412,192.8064643697,178.300523493201
"2687",474,85,389,197.70749182399,172.652417663848
"2688",471,82,389,192.707636118619,179.598693285587
"2689",483,92,391,196.060925229497,173.743476401977
"2690",474,84,390,192.131126381883,176.508477059974
"2691",497,89,408,194.892752069346,178.993626902315
"2692",489,83,406,214.788386647402,176.447592343672
"2693",474,86,388,197.252859307535,173.073098391364
"2694",490,84,406,194.641685892018,176.356761792418
"2695",496,82,414,204.154092798544,180.46381928234
"2696",493,94,399,197.135093954433,178.263550048428
"2697",470,86,384,187.357305957673,184.630528507161
"2698",499,85,414,201.791758855201,171.029015456116
"2699",476,81,395,211.452733241947,179.595089841125
"2700",503,90,413,199.555249307307,180.762904935292
"2701",473,92,381,190.857028837253,183.621177226132
"2702",503,86,417,200.712258705157,182.464593058236
"2703",501,82,419,196.108362544976,175.388730934815
"2704",488,83,405,189.553901944812,171.654377129346
"2705",478,85,393,199.960718320034,173.184800247866
"2706",480,89,391,197.614553003899,170.625547505224
"2707",488,86,402,194.77706750294,176.864979831867
"2708",491,83,408,191.092268174263,173.716773804447
"2709",480,84,396,181.220337994129,176.81658665784
"2710",473,74,399,194.89407553857,178.345012428129
"2711",490,87,403,188.626532605737,180.146977683976
"2712",494,92,402,195.248583607815,176.607001339545
"2713",494,89,405,203.395517401131,175.984760623866
"2714",485,89,396,189.196248931426,180.865728270518
"2715",487,88,399,186.43412981308,173.959422105286
"2716",483,85,398,199.656718299799,179.28323270993
"2717",481,90,391,187.426536717022,178.158897518793
"2718",486,85,401,196.062558132353,174.456415171053
"2719",481,87,394,197.548857600325,182.26303982822
"2720",483,82,401,206.391143980355,167.106005245956
"2721",486,90,396,185.780774500328,177.606705199619
"2722",475,76,399,191.663322573161,179.449979927548
"2723",493,79,414,209.647699688359,170.924389911585
"2724",491,90,401,194.925595786584,175.3444068303
"2725",484,83,401,205.556758544417,174.246143938566
"2726",496,79,417,197.549989959432,175.352162661156
"2727",492,88,404,185.283194665703,174.829837449126
"2728",488,82,406,178.297671976142,174.535277214391
"2729",497,84,413,205.588808611699,177.743985194497
"2730",499,86,413,183.016336879639,176.763476132168
"2731",474,85,389,193.523944553035,171.6069951827
"2732",486,90,396,213.60326857983,173.227926196356
"2733",473,84,389,201.852093255402,171.845286733699
"2734",490,83,407,180.20747880769,177.888845265512
"2735",491,85,406,197.717983055945,176.358884504529
"2736",476,89,387,189.970391037193,171.002047942572
"2737",480,77,403,189.321969858078,178.934807209072
"2738",509,87,422,200.909076572944,180.025686929119
"2739",481,87,394,204.436490300737,182.790246528494
"2740",489,80,409,183.630383245346,181.741019494528
"2741",475,81,394,204.862057707261,183.191975251566
"2742",492,88,404,190.581980101711,178.246832756913
"2743",498,86,412,198.629702684721,178.75686008286
"2744",491,87,404,192.928898971729,176.963694169222
"2745",490,87,403,193.147399113316,178.608560080821
"2746",497,83,414,191.72885513259,177.924943385191
"2747",481,86,395,200.659534818511,175.558584060311
"2748",473,80,393,203.352913096682,174.966041766514
"2749",502,82,420,204.575389087334,177.849595660885
"2750",499,88,411,191.63769061,183.228420394674
"2751",480,89,391,183.935382405928,176.42964424926
"2752",493,92,401,205.030669283138,179.503275842666
"2753",496,87,409,193.885460835952,179.821032327498
"2754",501,95,406,196.106627347463,178.669849494661
"2755",478,79,399,211.068153581891,177.782413088551
"2756",481,83,398,196.724153420732,172.340451892116
"2757",489,94,395,198.035388168833,183.883464720146
"2758",479,85,394,207.593756003817,176.074337860347
"2759",481,83,398,194.909571754746,174.675847627957
"2760",482,94,388,183.899181724787,173.577146111363
"2761",498,85,413,197.237693090979,180.058362334576
"2762",488,86,402,184.415509486549,171.296597950505
"2763",481,88,393,184.554710036584,173.441143648036
"2764",495,83,412,181.607481791185,178.271981583141
"2765",495,91,404,197.224135816722,175.438447131859
"2766",484,89,395,194.063439621512,175.578605007433
"2767",475,80,395,187.689068866465,175.637568226417
"2768",479,87,392,211.159764472123,173.421558564499
"2769",489,83,406,184.430994937949,174.042768581384
"2770",475,85,390,194.233739170793,172.772205292589
"2771",494,87,407,176.712161446766,175.402963615503
"2772",465,83,382,196.623967939372,177.256529125002
"2773",491,88,403,198.341545550308,176.87515763057
"2774",491,87,404,204.741876742236,176.453925856257
"2775",491,93,398,196.164536129092,179.44382241827
"2776",495,87,408,193.187019285713,175.420539824294
"2777",498,92,406,196.024480385364,171.61328777298
"2778",473,77,396,198.921353272355,175.283247272693
"2779",488,86,402,198.20561266318,174.414929591698
"2780",465,85,380,200.95447679369,173.669123145732
"2781",488,77,411,190.226827262657,175.476704432516
"2782",467,89,378,191.973957283844,173.988324377288
"2783",472,79,393,200.394238238833,170.69343555721
"2784",472,88,384,198.600801163911,174.242796973271
"2785",487,83,404,193.130185040353,174.745282521958
"2786",486,88,398,180.555421365568,176.646073836268
"2787",507,83,424,207.098671351711,170.761486062753
"2788",482,93,389,190.285116018832,169.462261799952
"2789",490,89,401,203.885476518422,173.218264516364
"2790",465,79,386,192.379047099103,177.654716823756
"2791",481,83,398,209.81228376852,178.475349424333
"2792",488,84,404,192.11607304161,175.240764904997
"2793",500,89,411,197.072721434804,178.290114049801
"2794",486,82,404,188.337033083191,178.810824435549
"2795",493,81,412,191.96727888846,179.936766712711
"2796",497,86,411,202.591206086803,177.285259829048
"2797",482,83,399,199.280769790691,180.120718323106
"2798",487,90,397,198.307796846444,177.874948762265
"2799",477,83,394,184.023592823945,178.053302944049
"2800",482,89,393,196.804101503699,176.712835737039
"2801",477,82,395,196.83399676383,174.678965366374
"2802",498,87,411,195.321843452152,180.043037888704
"2803",489,85,404,190.102345140253,177.309728297946
"2804",491,95,396,190.850311266537,175.395005111232
"2805",474,87,387,186.142272270693,181.382802921257
"2806",493,79,414,203.442804241668,178.548369094985
"2807",492,87,405,192.84972042579,176.915639018715
"2808",460,83,377,199.964602178703,179.737168409721
"2809",490,92,398,199.392377118703,171.323637780523
"2810",463,89,374,197.653268810375,169.527191483101
"2811",504,93,411,193.592900017003,174.206988964454
"2812",488,85,403,170.918607733371,179.192746364059
"2813",474,83,391,194.940706648038,180.905723612763
"2814",484,95,389,180.406772924258,180.963671552924
"2815",498,92,406,201.241592940699,177.443884088126
"2816",486,81,405,190.251475731313,174.934602161439
"2817",501,91,410,202.282100560312,178.210408781976
"2818",493,90,403,194.568157414511,172.668495919236
"2819",505,90,415,196.826011964344,176.179502754931
"2820",472,86,386,195.169132838399,182.857168726469
"2821",486,94,392,185.580527629659,175.927108527592
"2822",486,85,401,181.470144562732,178.082453454381
"2823",507,92,415,198.00279509194,178.00938926309
"2824",488,83,405,199.873014062894,174.503142068619
"2825",495,87,408,197.63180655179,179.179047643643
"2826",468,90,378,191.848224520328,176.701640681227
"2827",504,84,420,196.193538495574,181.39752259429
"2828",492,86,406,197.440187930366,174.570044750223
"2829",476,88,388,200.128298673881,172.79104209762
"2830",488,86,402,197.714991739101,174.961205394708
"2831",488,88,400,190.429461705186,184.073522442268
"2832",461,90,371,197.47265379215,177.119668783609
"2833",503,89,414,202.054217776174,174.088172295337
"2834",487,86,401,203.271624634466,171.346328788741
"2835",484,92,392,192.968638359531,178.577234656409
"2836",482,85,397,194.103946012436,174.384328953722
"2837",489,85,404,191.472530048603,176.854107258987
"2838",484,90,394,195.863073062391,170.318570293203
"2839",470,84,386,195.731390453513,177.422772625727
"2840",489,85,404,199.202892319409,182.674511470928
"2841",466,79,387,185.893819496315,180.043241705362
"2842",491,74,417,190.116006030483,175.874739613162
"2843",487,85,402,202.057770094709,181.734653831036
"2844",483,85,398,200.107492617473,172.516640364514
"2845",485,85,400,198.460518327972,171.933869311852
"2846",473,89,384,178.144851305502,176.294762926943
"2847",496,83,413,192.203376353856,183.228962692663
"2848",498,87,411,187.947953306083,182.365051458271
"2849",488,90,398,200.282782785659,176.699543107226
"2850",490,87,403,194.710210107872,176.906884639891
"2851",492,84,408,182.947102280541,172.20006069264
"2852",495,96,399,199.794864214322,176.633272100916
"2853",484,84,400,191.691479384942,180.267429801948
"2854",486,90,396,191.621013575639,182.141163148004
"2855",475,82,393,196.378421870106,175.351113087547
"2856",477,80,397,201.461205882224,172.712467652124
"2857",478,84,394,193.545220928629,174.953224305815
"2858",484,90,394,191.878554313978,178.70516938846
"2859",501,86,415,202.946406817861,175.279948697792
"2860",493,90,403,201.638543891162,174.871511262302
"2861",494,81,413,204.736018619939,182.526450510726
"2862",497,87,410,205.317863115597,170.607364145794
"2863",489,91,398,179.556429783548,172.964263740304
"2864",462,92,370,195.333579584047,176.729040801763
"2865",482,84,398,197.3218497021,177.128754003478
"2866",482,79,403,193.176244937037,182.413136558529
"2867",468,76,392,202.310832787539,177.006848232849
"2868",467,88,379,203.901086849375,174.949980606201
"2869",470,78,392,199.826809258356,171.888646443854
"2870",476,84,392,196.328194136811,175.423928052957
"2871",498,88,410,198.298648543046,174.878497258355
"2872",486,82,404,200.862018473088,186.86260356622
"2873",476,86,390,199.639357103966,180.130405443145
"2874",474,82,392,200.07228894959,175.20652378047
"2875",473,80,393,194.306287787097,178.731080051666
"2876",495,91,404,202.542319037098,173.667912782117
"2877",494,94,400,190.249585491707,175.178760964708
"2878",492,84,408,200.438491558766,188.289631934158
"2879",478,88,390,196.266482869614,166.829111214202
"2880",482,79,403,209.697211127485,177.393617428535
"2881",477,92,385,188.499300452591,174.273778120892
"2882",485,83,402,192.751222044545,170.289802288399
"2883",484,89,395,206.784021969297,180.798390405587
"2884",482,93,389,190.095614195909,184.383920395644
"2885",480,80,400,194.177332314109,175.414328696314
"2886",475,88,387,191.045990615033,177.129078166756
"2887",498,93,405,196.52393093178,182.325685577486
"2888",474,86,388,191.416313215127,180.053905674911
"2889",479,75,404,196.65701229068,177.33220260962
"2890",469,78,391,194.644830208179,172.828314970757
"2891",487,97,390,189.522863711092,179.562865706258
"2892",490,84,406,194.120197054592,173.187180738797
"2893",474,88,386,208.866810647869,178.298829777994
"2894",494,89,405,191.317398487696,173.793340958657
"2895",493,81,412,204.058560878522,182.36120438137
"2896",498,88,410,201.18239776581,172.677459523673
"2897",481,91,390,190.119868694899,180.308676534601
"2898",479,88,391,197.503817495562,177.725509670326
"2899",486,90,396,182.2718189777,180.654575383684
"2900",479,83,396,195.789899674613,183.280992148647
"2901",482,79,403,193.089272865451,174.233318474687
"2902",479,91,388,186.444109617041,181.575739546902
"2903",487,81,406,193.338414101933,173.849634947215
"2904",489,84,405,190.859022132517,176.760657739248
"2905",472,79,393,192.744988684709,176.243313390005
"2906",461,80,381,191.248102537089,178.414014078459
"2907",474,86,388,184.815754955672,172.687632396275
"2908",483,88,395,189.561529617466,178.024103420575
"2909",473,89,384,201.894074564022,173.987592468294
"2910",490,94,396,193.078740723574,169.338383896579
"2911",494,89,405,200.169238265581,175.211665610959
"2912",491,89,402,196.267073959956,179.942574434032
"2913",473,81,392,194.885733305249,179.408060035772
"2914",494,83,411,185.231775370108,175.390131721714
"2915",466,85,381,195.36581515842,173.242486001278
"2916",484,89,395,188.642055981641,173.60556716469
"2917",472,83,389,204.164150731275,178.704415112154
"2918",492,85,407,194.283854043259,170.906386952268
"2919",486,84,402,190.683275702741,177.592819462537
"2920",493,91,402,194.577639943719,171.035804340808
"2921",500,101,399,183.721257796015,174.170028067887
"2922",472,89,383,188.05607214927,172.536357699531
"2923",493,96,397,188.396274539842,181.613028931955
"2924",505,90,415,185.582633859855,183.522438271253
"2925",488,84,404,197.335465224948,180.66202086954
"2926",482,92,390,205.728686263483,180.404860161416
"2927",494,85,409,201.415671730087,176.444239450372
"2928",500,97,403,188.292883041313,176.862970244303
"2929",485,86,399,196.795409526187,166.018642436732
"2930",479,85,394,189.324062947875,170.399964266787
"2931",477,88,389,195.700510245479,181.00626124845
"2932",505,94,411,207.303592047707,178.303933636723
"2933",498,90,408,207.271930287055,180.075747522303
"2934",475,82,393,200.03179185411,177.301102632731
"2935",491,80,411,194.419973369068,175.225413035837
"2936",467,78,389,203.215224500123,174.929786003164
"2937",487,92,395,182.477868380354,176.951893990859
"2938",474,78,396,206.206437194072,179.776494240819
"2939",488,85,403,207.397359114143,175.173176674014
"2940",474,82,392,200.813858103087,172.815853772919
"2941",495,96,399,200.926704798182,172.797283896328
"2942",490,88,402,195.685291748707,178.97826589664
"2943",485,88,397,194.613872499424,173.589581868671
"2944",475,82,393,196.436207239822,179.807216845389
"2945",487,85,402,192.632990697599,178.473073050247
"2946",483,82,401,195.244574676276,177.17802095768
"2947",474,76,398,198.116501452042,176.567164132658
"2948",480,82,398,182.687911923735,176.676841292811
"2949",497,82,415,207.50931075293,179.824473107787
"2950",480,87,393,201.05523187912,172.234691894916
"2951",486,90,396,191.283584351184,170.790533657127
"2952",490,84,406,189.86551466137,179.696297468504
"2953",497,85,412,196.991620409618,178.442448238989
"2954",473,96,377,190.786282067265,174.04245297502
"2955",475,84,391,197.470656694054,173.777972326561
"2956",495,90,405,192.566888778695,173.109832376369
"2957",488,87,401,199.367220634105,174.092461481517
"2958",479,81,398,190.344198369997,182.57815921159
"2959",483,90,393,197.022405677124,179.963489699654
"2960",495,90,405,201.925714141294,180.499990706369
"2961",478,90,388,206.685230545428,170.993088506078
"2962",476,83,393,184.332427007288,176.904584384288
"2963",490,95,395,180.341346756996,168.372990858779
"2964",505,92,413,193.551328940235,180.186080215158
"2965",472,85,387,179.118313668354,177.768502252881
"2966",487,83,404,195.806157805248,173.923109335607
"2967",494,84,410,195.916799539723,181.586196459293
"2968",496,80,416,195.710882710371,176.858650855794
"2969",476,75,401,200.099620858347,173.131087198779
"2970",487,91,396,191.086715504026,175.420037316119
"2971",478,85,393,193.578108160399,174.650648565312
"2972",473,81,392,200.008496276273,171.345504082373
"2973",475,83,392,199.245861438832,179.220998548946
"2974",492,88,404,194.90558716319,178.580632957558
"2975",493,88,405,198.454493615585,182.423753687626
"2976",486,80,406,188.352530920333,178.103860402791
"2977",486,83,403,200.543326094039,179.997934243354
"2978",496,92,404,201.258266283846,173.946959397102
"2979",502,91,411,201.888862264192,177.97456582054
"2980",485,92,393,202.001945507333,182.164417943529
"2981",482,84,398,197.433407064517,175.752601954735
"2982",493,86,407,193.897755949287,172.05408385385
"2983",495,83,412,197.083711610767,176.662590649776
"2984",475,85,390,200.690369586994,183.094939932053
"2985",485,86,399,201.387822490478,177.226851634233
"2986",495,87,408,192.681021885259,174.786773554687
"2987",496,87,409,196.88831744763,176.629180770947
"2988",485,87,398,184.758405157847,179.929343326087
"2989",485,90,395,187.867176417868,174.509620793391
"2990",500,86,414,197.020095393751,175.379721801637
"2991",505,86,419,214.45495921445,177.708601317677
"2992",470,85,385,188.114825100856,176.400717338636
"2993",487,92,395,186.289479505939,174.99123971163
"2994",489,98,391,188.683736343098,174.46934621671
"2995",489,94,395,205.192647062948,177.500602103974
"2996",489,87,402,195.173191520139,169.726213418165
"2997",502,88,414,190.316497686702,177.114514062423
"2998",487,86,401,191.115517986265,173.670094327049
"2999",477,85,392,190.218505626422,179.060789134782
"3000",480,81,399,192.074770311642,174.409117926157
"3001",478,77,401,212.525789789638,172.829927543138
"3002",494,90,404,182.211087674077,180.672189106244
"3003",487,84,403,196.862909454522,181.460523509066
"3004",480,88,392,201.434682264542,177.825266919366
"3005",471,85,386,200.262017256176,178.013063398473
"3006",496,88,408,200.577561865902,181.244321081246
"3007",481,78,403,190.493408111774,181.132584704097
"3008",483,84,399,189.507719180959,176.710982878319
"3009",479,84,395,209.328231686943,178.346173411248
"3010",479,80,399,208.083875882272,182.978607242026
"3011",489,87,402,186.929446648402,177.255310653543
"3012",487,87,400,193.527591912121,175.397495360279
"3013",476,86,390,183.04209585661,176.705735526504
"3014",499,83,416,200.792130949297,180.356427367247
"3015",510,91,419,190.164111905059,183.712092824701
"3016",486,83,403,194.888896555249,175.177890357275
"3017",473,86,387,194.426979948104,178.37548338154
"3018",487,88,399,188.768791782756,173.792601565693
"3019",495,86,409,194.125595346827,172.754658855124
"3020",491,84,407,192.413391400948,178.733470711086
"3021",490,89,401,190.262227222867,174.841642715055
"3022",478,82,396,194.341013642279,174.005119913389
"3023",488,84,404,187.054865544277,175.083529263667
"3024",473,84,389,183.533588586532,177.209027120733
"3025",479,83,396,190.160257651864,175.902924616546
"3026",485,81,404,197.058271100616,179.592583905844
"3027",476,85,391,203.965353040761,178.05408365124
"3028",487,92,395,199.561748138784,174.608050994795
"3029",475,80,395,194.932150771794,168.755475284668
"3030",486,85,401,202.034810160803,178.68181290675
"3031",486,86,400,177.483330206198,177.08056922883
"3032",475,85,390,198.517154359189,179.497805283246
"3033",490,95,395,188.373733646672,178.94541588852
"3034",484,90,394,185.915525246416,173.520925232017
"3035",499,92,407,182.34173159893,179.229865715462
"3036",497,88,409,194.104584270175,182.561933995179
"3037",499,87,412,205.987431064983,171.073086294464
"3038",469,84,385,191.57329184571,178.727831303536
"3039",503,96,407,197.411972513655,171.755844485447
"3040",491,91,400,204.238711148346,176.905747379422
"3041",477,84,393,192.556402013694,176.780653602841
"3042",499,93,406,197.227803595614,179.549655740031
"3043",479,83,396,196.923679446042,173.813260263392
"3044",486,84,402,199.782463525743,180.861095006266
"3045",470,75,395,193.44320131444,173.306842427519
"3046",476,84,392,185.447653833876,171.112057943653
"3047",491,85,406,191.22496082055,183.013207872869
"3048",477,86,391,197.099974847117,180.423742509938
"3049",491,85,406,196.489353731667,174.007080733731
"3050",478,77,401,206.695400628274,179.807394636934
"3051",494,94,400,187.930662957168,182.232438001691
"3052",465,83,382,196.266914463134,169.087310835249
"3053",477,86,391,197.527045233114,174.477210930206
"3054",487,84,403,201.232346042417,177.605321404128
"3055",485,91,394,191.279815378522,168.812632472984
"3056",492,88,404,194.187700546212,179.553696182951
"3057",490,99,391,186.218734288466,170.988149781072
"3058",503,96,407,186.138803251049,172.615013839535
"3059",492,97,395,184.713308195659,176.642937014897
"3060",500,93,407,184.372113211788,177.275898664124
"3061",480,85,395,200.748716324577,180.17670418838
"3062",484,82,402,193.045439699159,179.992231121008
"3063",498,85,413,209.163242366197,175.985917444269
"3064",479,81,398,200.23541151015,173.267282838615
"3065",486,83,403,206.888904871774,180.69814329205
"3066",495,90,405,182.35707336916,187.226207651208
"3067",479,86,393,191.275615239643,176.664901937749
"3068",467,85,382,194.775577932029,174.144606853695
"3069",480,87,393,185.31555904248,175.696131530872
"3070",480,85,395,183.267766448624,173.640121157103
"3071",468,87,381,204.523218421694,172.30318872268
"3072",481,79,402,195.636684486001,179.933173601214
"3073",489,91,398,189.840374587697,178.883810064119
"3074",503,97,406,201.710754603103,173.136779666354
"3075",490,82,408,198.878906521493,180.554148320832
"3076",470,84,386,191.19678424425,171.927508752815
"3077",489,87,402,198.059245735069,174.129017013726
"3078",493,94,399,193.594106586072,176.44293840166
"3079",478,84,394,179.263803497997,182.969997939619
"3080",495,85,410,184.525524332742,178.526912448457
"3081",464,84,380,195.1732984552,166.972314821855
"3082",497,92,405,192.648947010745,173.189321108132
"3083",495,89,406,194.945301628484,177.170858421866
"3084",458,76,382,194.447058630005,180.465091912122
"3085",479,83,396,195.952227764291,171.813638107689
"3086",471,81,390,206.456443365581,180.234960001423
"3087",494,88,406,196.86483899912,174.335841206125
"3088",483,85,398,202.420482291798,181.369814741077
"3089",472,79,393,205.138439678811,171.11298907832
"3090",488,90,398,185.30413915992,169.221409953457
"3091",481,90,391,200.445005034843,174.015659538034
"3092",486,90,396,192.429698480422,173.877717995886
"3093",485,80,405,208.520691668802,177.26612840538
"3094",465,87,378,191.051968001213,176.751248368909
"3095",486,86,400,205.979233724503,176.337502239671
"3096",498,89,409,194.824746265527,184.953885843627
"3097",483,86,397,198.960364690501,180.390287234025
"3098",486,79,407,201.210693304781,180.731827005316
"3099",493,87,406,193.26871024487,182.520494616811
"3100",484,84,400,176.312489372422,176.338194402586
"3101",484,84,400,191.109931538046,168.840886563701
"3102",487,83,404,197.6797011108,176.507536115428
"3103",487,86,401,203.539415684972,181.763707493701
"3104",481,87,394,189.126649224859,169.793404937699
"3105",481,97,384,188.419071398278,179.263756147379
"3106",498,80,418,194.746382228273,172.624434706449
"3107",489,86,403,199.182775448984,175.823283931873
"3108",483,92,391,188.672929846141,177.734905639103
"3109",494,95,399,200.981354965262,175.313979851708
"3110",490,89,401,195.241337115086,175.323346493823
"3111",485,92,393,198.843507056851,174.148977978906
"3112",486,84,402,190.709089742761,174.960771459941
"3113",491,87,404,195.708982187883,174.921505894745
"3114",484,86,398,189.585613327085,182.492798945293
"3115",486,82,404,207.479071729834,180.081680300252
"3116",475,94,381,185.341384930692,180.859942874555
"3117",475,91,384,202.678490489621,175.085134778619
"3118",477,86,391,202.564214614457,175.348516142963
"3119",501,82,419,196.175626032118,177.707772016883
"3120",480,86,394,193.716207125992,179.804144415471
"3121",474,86,388,208.097620376292,174.219279226163
"3122",493,82,411,208.985981761281,174.856575440664
"3123",481,78,403,195.613883053645,173.922767637301
"3124",497,91,406,187.232571568365,180.832380300399
"3125",496,87,409,187.912171875529,175.05405022498
"3126",474,84,390,203.752590284292,173.2968690173
"3127",477,84,393,192.551761140978,183.381871046071
"3128",498,88,410,190.955597671355,171.081027171003
"3129",494,95,399,198.754674325702,180.68567587371
"3130",481,83,398,195.639116368513,178.771503373569
"3131",468,75,393,190.034733125533,176.912941087216
"3132",474,87,387,203.894759248702,170.211378849857
"3133",479,83,396,184.803902693491,176.72422142873
"3134",479,90,389,196.289191145217,180.143566105314
"3135",476,80,396,198.074102577684,175.839793138035
"3136",490,87,403,203.854441703503,176.991621355771
"3137",493,81,412,202.92709553696,169.924658857534
"3138",498,88,410,209.530731798237,176.977447801802
"3139",475,80,395,193.244924382523,181.218409061838
"3140",509,86,423,199.73537391946,181.129990709574
"3141",474,87,387,189.920774020636,180.280137115002
"3142",482,87,395,207.031759473888,177.898137998471
"3143",482,81,401,205.844112821177,173.286013996947
"3144",490,96,394,189.003248154925,181.220127615153
"3145",482,85,397,193.991783959659,173.098086117897
"3146",500,85,415,191.222570737568,177.099159243606
"3147",480,86,394,198.275053870306,177.501079725292
"3148",485,92,393,195.718208042442,178.676954788681
"3149",483,91,392,202.113263494416,177.529661809086
"3150",490,84,406,187.726029206723,177.573355157526
"3151",475,81,394,202.272555405767,177.156049913878
"3152",505,91,414,208.851477460672,171.993610853483
"3153",473,84,389,185.526248810314,174.674899483246
"3154",502,86,416,192.316506705947,181.065659691197
"3155",496,85,411,196.221212067736,176.257244449407
"3156",491,85,406,199.566993006811,179.977122920777
"3157",483,85,398,209.981940563097,177.887948737262
"3158",481,81,400,192.899960251006,179.476780071226
"3159",482,85,397,190.578442082977,178.288282570313
"3160",485,84,401,188.36219462818,177.913351485499
"3161",501,91,410,197.911787730895,171.06561025893
"3162",476,76,400,206.445508953762,179.000091887351
"3163",498,81,417,203.10891199798,174.271102751063
"3164",484,90,394,202.577850308084,175.885049552896
"3165",487,85,402,205.343296883911,173.251446100817
"3166",480,89,391,190.211326641148,172.308610005429
"3167",475,87,388,192.809483475213,174.79571597263
"3168",481,79,402,199.150234872123,174.485579412475
"3169",474,80,394,189.546542207137,177.283457617274
"3170",492,89,403,180.748387085331,178.097457257223
"3171",497,87,410,205.152273139395,171.848087576892
"3172",481,91,390,185.296782302835,174.647281228406
"3173",494,83,411,193.212981891429,178.924750654256
"3174",489,84,405,189.218561052263,179.022095431284
"3175",485,91,394,203.73462377106,180.203682546057
"3176",473,83,390,184.638387784689,177.286450544559
"3177",465,84,381,188.678972312411,177.655045152945
"3178",467,87,380,198.045869840298,174.536106742314
"3179",498,83,415,185.74480000085,182.942191153195
"3180",468,78,390,197.534524523897,180.547389239923
"3181",477,82,395,205.917265054679,174.236282171174
"3182",479,82,397,194.817200379088,180.140120251462
"3183",489,81,408,196.099522249994,174.954132684439
"3184",485,86,399,202.538003922374,177.15524103111
"3185",481,86,395,197.590776408493,175.187255416731
"3186",476,79,397,185.383631953152,179.766019117627
"3187",485,87,398,187.880788517021,177.744223487242
"3188",467,90,377,190.47117820885,175.49999052994
"3189",489,80,409,206.557254627635,175.92392903816
"3190",476,82,394,198.641356747366,176.726483041073
"3191",478,85,393,189.511648941402,180.361263557841
"3192",491,95,396,190.865531674053,178.293915095005
"3193",505,92,413,200.774674887251,177.014899169849
"3194",482,74,408,210.84945543946,177.588511255184
"3195",486,85,401,178.349465029503,177.327879390542
"3196",495,92,403,212.334480128152,174.83329518383
"3197",487,83,404,198.595962723074,176.648948409263
"3198",491,82,409,201.048793192885,178.758156702269
"3199",514,92,422,192.224837515556,170.513681716331
"3200",486,86,400,194.965905119811,180.618557151123
"3201",472,82,390,182.986742121905,178.027567827409
"3202",489,92,397,197.653952013774,182.158508155937
"3203",487,86,401,194.813055014107,175.848004632909
"3204",480,86,394,190.213995826057,174.818573528521
"3205",493,89,404,204.263290430235,175.306521496852
"3206",473,74,399,193.234582675859,175.072669949167
"3207",489,93,396,210.527213395183,176.547263977454
"3208",478,81,397,195.122565718128,178.728548172349
"3209",510,87,423,186.903595823825,179.503707298997
"3210",473,79,394,196.904843006174,173.419908541552
"3211",488,91,397,187.762806350659,175.331566036747
"3212",470,74,396,194.663727074875,177.220172138388
"3213",484,77,407,205.574046663704,172.908138572789
"3214",482,87,395,180.557609713004,175.06272839155
"3215",491,93,398,186.23594726062,181.160653476646
"3216",470,87,383,180.517404371878,169.878608982276
"3217",488,89,399,200.105303642249,169.246419371856
"3218",483,84,399,193.106483127382,174.260145848192
"3219",481,87,394,200.730526560849,173.865758074902
"3220",475,83,392,199.509256411323,174.50911336662
"3221",479,83,396,205.125621965633,177.248011724185
"3222",487,79,408,196.222305159622,175.986516461083
"3223",489,87,402,197.641711617611,178.166806063231
"3224",476,88,388,181.121210286804,171.213894167383
"3225",479,90,389,194.070694841455,181.246562413483
"3226",501,88,413,202.276187126523,177.647808754964
"3227",483,87,396,199.683585036967,182.635079913192
"3228",482,87,395,194.736303531149,177.231260966218
"3229",481,87,394,186.420498478939,172.234001674963
"3230",489,92,397,191.861903286443,170.488688337113
"3231",499,88,411,191.019470955602,174.223326081219
"3232",475,84,391,196.201946889184,174.54185119046
"3233",507,81,426,196.699089833276,178.413187428703
"3234",478,90,388,198.397720647496,171.424730150431
"3235",484,84,400,199.441174867035,181.791880201286
"3236",488,86,402,194.224947669989,180.650555314722
"3237",475,87,388,207.494552910678,174.401953211032
"3238",481,87,394,185.369666715541,171.363906098834
"3239",486,84,402,192.484398158674,181.526443653707
"3240",478,86,392,193.729472495333,179.089219425957
"3241",488,82,406,200.739322120265,186.046255950486
"3242",469,82,387,190.511364593296,179.84399177028
"3243",478,80,398,197.809302242154,172.50478564512
"3244",477,82,395,191.503135746678,169.506152094416
"3245",483,87,396,189.038488620135,174.572709389925
"3246",497,81,416,190.467039393609,176.273635205241
"3247",485,79,406,191.488610822229,181.415218521122
"3248",484,90,394,180.193011194592,176.590822723775
"3249",489,88,401,183.670755116887,179.252880097245
"3250",488,83,405,190.935288895884,170.226340267626
"3251",476,85,391,192.513411671131,178.964896773223
"3252",477,87,390,198.720129009621,179.351399322846
"3253",485,89,396,190.22103718257,172.169313469676
"3254",487,85,402,192.27298367168,173.977669106014
"3255",478,84,394,200.122831535898,174.023153117518
"3256",475,90,385,195.633292812715,180.500557934381
"3257",475,75,400,191.704840514288,184.369507052832
"3258",492,83,409,202.77952968271,181.080796946066
"3259",494,93,401,194.682424477787,176.940619352676
"3260",484,87,397,188.116253511361,179.712446090189
"3261",478,74,404,197.287408482158,170.423075140666
"3262",488,90,398,192.227833127854,173.628517235238
"3263",477,82,395,215.976426188216,179.606648463299
"3264",467,87,380,194.560729446953,173.943332563603
"3265",482,84,398,196.338830045843,177.982933603567
"3266",476,83,393,194.021722690776,174.975324708313
"3267",474,86,388,178.899121064687,169.540805205831
"3268",495,90,405,206.223210373586,173.36834066396
"3269",483,79,404,191.399975950579,175.909648617015
"3270",482,93,389,197.976463705949,178.554188727934
"3271",488,87,401,192.514546145175,173.686537721816
"3272",476,81,395,192.094912946114,180.482945209318
"3273",467,84,383,197.105865910521,175.143715449816
"3274",482,86,396,197.622313742365,183.311187897459
"3275",492,90,402,193.529466743189,173.038625369467
"3276",475,83,392,200.180497152609,179.759694716239
"3277",483,87,396,189.252975707461,175.767137723127
"3278",498,91,407,192.60771342854,178.638744041976
"3279",464,82,382,199.20620810644,171.091353155213
"3280",481,82,399,188.268262222741,175.600119300447
"3281",475,88,387,199.885480533799,175.180146288192
"3282",486,84,402,201.631917342059,176.404724760955
"3283",480,97,383,178.829836493733,173.30720532058
"3284",481,79,402,206.029236175053,173.638294487836
"3285",470,79,391,206.356652039921,177.177621018458
"3286",485,87,398,197.147678277619,178.587573602154
"3287",475,86,389,204.776413006703,180.635011514724
"3288",500,90,410,186.901968028855,174.514182825167
"3289",479,81,398,198.968199217649,171.154139578426
"3290",483,81,402,194.40446473184,169.530697480881
"3291",471,89,382,187.164121023701,178.068644606145
"3292",465,90,375,188.788519473547,176.758623432046
"3293",488,82,406,190.022025753084,175.866314597602
"3294",484,85,399,200.154049227908,170.801806005303
"3295",495,83,412,198.75541235742,181.54664686374
"3296",479,84,395,197.626948522445,181.927572877754
"3297",489,85,404,197.150362565406,176.122872214425
"3298",508,93,415,173.490192352448,179.818552866328
"3299",475,79,396,203.873830689013,171.360842338712
"3300",478,84,394,198.353351886737,180.419407017492
"3301",485,79,406,196.598110027414,174.447021524625
"3302",489,87,402,194.287885817797,176.180675144715
"3303",485,86,399,193.454336131861,175.950914285085
"3304",499,91,408,205.488495604445,178.31133576434
"3305",466,86,380,183.001229887532,178.524633897459
"3306",502,87,415,197.930981030345,183.487370534159
"3307",487,75,412,204.427922810372,175.376416508345
"3308",488,82,406,194.691811440349,173.908107964078
"3309",477,87,390,187.345487515129,175.069645193564
"3310",477,81,396,199.990357164611,173.904540109931
"3311",485,90,395,184.936870093503,174.534233635593
"3312",483,78,405,187.25361406856,179.113558512335
"3313",489,85,404,183.757161480466,172.225774678819
"3314",494,85,409,179.689539555384,179.042396192016
"3315",483,87,396,195.690332196481,179.121683228051
"3316",479,83,396,200.999789251923,180.838009561504
"3317",480,82,398,191.309339133387,183.242775325384
"3318",478,87,391,188.937644337354,183.362320135701
"3319",485,90,395,197.411716420122,173.236808907452
"3320",492,93,399,202.919257979475,180.773919555261
"3321",484,86,398,195.138898338814,182.010777878365
"3322",476,82,394,191.508784862122,174.160351986925
"3323",479,84,395,192.105629059612,174.890271028367
"3324",492,90,402,192.831991074321,174.663968910344
"3325",464,84,380,195.171212409125,177.625974837461
"3326",496,87,409,200.775379907276,172.576390142944
"3327",493,83,410,181.535650728194,175.815904504711
"3328",497,84,413,199.316500498166,175.553874084877
"3329",481,84,397,202.57257395161,174.902977781325
"3330",496,88,408,189.607200116279,182.899196886499
"3331",473,87,386,195.606418296218,183.255084147788
"3332",476,87,389,198.386840711552,178.980697198188
"3333",497,81,416,197.841554414084,176.113482703083
"3334",481,84,397,201.295420177789,175.897492213838
"3335",480,90,390,195.668605177293,177.177179589259
"3336",499,81,418,194.785342452973,182.64203989147
"3337",478,89,389,211.139386960281,165.528185292686
"3338",488,91,397,197.877261470153,176.10448430796
"3339",494,90,404,190.100864402272,176.535243503111
"3340",491,94,397,191.853471164691,177.744158021251
"3341",474,80,394,193.430797265888,175.0067074853
"3342",485,86,399,197.346050437114,181.552723149363
"3343",482,78,404,195.309183950457,171.992815562246
"3344",469,84,385,192.026812436559,179.257622339095
"3345",476,84,392,204.121482789182,178.338356924577
"3346",481,81,400,206.4599878383,183.978102461286
"3347",492,92,400,196.029738883216,180.10252595114
"3348",487,85,402,200.676259899154,176.762570579889
"3349",483,81,402,192.271633469277,177.791418857742
"3350",498,91,407,210.343827413684,183.349747586568
"3351",490,93,397,194.281434302183,175.903721724941
"3352",497,95,402,195.065588011018,177.292816718717
"3353",494,93,401,194.156117596868,179.501875774925
"3354",490,87,403,194.027262069418,172.659514447525
"3355",506,88,418,195.189609466197,177.257077030396
"3356",478,78,400,196.208218439216,182.235721397658
"3357",482,87,395,200.346183564391,180.734148664371
"3358",480,89,391,183.561309416198,181.91008671662
"3359",476,92,384,187.006396550827,172.741598951881
"3360",488,86,402,189.350883045804,175.254474690968
"3361",479,86,393,191.763177485719,178.97401585323
"3362",483,95,388,192.428284736639,180.188985930875
"3363",495,96,399,196.199488154986,177.972967951643
"3364",481,85,396,197.025541442551,175.846511346899
"3365",470,72,398,194.321743248989,177.303283479933
"3366",479,91,388,193.874763594186,171.987452182669
"3367",494,92,402,199.045653561225,178.95436383287
"3368",488,87,401,188.989507246655,175.859383945918
"3369",481,83,398,186.159521668328,180.409361597115
"3370",486,79,407,202.429993209803,175.51588760035
"3371",468,81,387,187.076076556815,172.847163423584
"3372",483,85,398,193.902411527794,173.045140906993
"3373",483,85,398,193.121127264376,171.325888686463
"3374",480,88,392,209.134050390011,176.393264273293
"3375",480,90,390,188.591888809729,177.999055775967
"3376",483,84,399,206.138293266657,173.393561567776
"3377",484,89,395,194.999276219213,182.715170207631
"3378",486,88,398,191.644571072978,180.029279534229
"3379",487,86,401,192.348537982675,170.82441539839
"3380",478,80,398,185.407814648978,173.241539915546
"3381",480,84,396,197.518249871692,171.77467637526
"3382",475,80,395,203.51907353484,174.99617253351
"3383",495,82,413,202.953645327391,182.322843305713
"3384",487,87,400,202.201284958135,172.001680481596
"3385",479,87,392,194.572587804275,184.089652292987
"3386",487,97,390,197.391777935847,172.938710134821
"3387",476,87,389,194.47483931422,176.10907705001
"3388",482,82,400,192.240869531317,173.726535297666
"3389",485,88,397,204.542916660156,173.109325771324
"3390",486,87,399,195.477327293724,175.80475111196
"3391",460,80,380,190.231632191673,174.42882213279
"3392",483,81,402,193.920112352633,176.49658657871
"3393",485,86,399,207.123238770395,180.74253459849
"3394",487,81,406,197.549863228775,175.869507358685
"3395",474,85,389,202.280437502799,177.006719877393
"3396",487,78,409,199.372793241351,171.596174298498
"3397",497,95,402,209.707894192337,176.201878990122
"3398",493,90,403,183.686503794153,179.276749739181
"3399",493,96,397,199.638270236823,174.848107563932
"3400",493,87,406,195.155187776106,175.527528474007
"3401",474,86,388,196.959167284355,174.718686655261
"3402",493,90,403,198.580427110139,175.048486345219
"3403",476,81,395,200.022068911154,170.347973063255
"3404",501,87,414,203.721419072237,179.993505835547
"3405",495,87,408,197.811424008421,172.301467958028
"3406",506,79,427,201.499429097564,173.273727443729
"3407",488,90,398,204.840659094263,179.643352866337
"3408",492,87,405,189.886874897919,180.546885997609
"3409",486,88,398,197.592103409034,174.268741658495
"3410",481,85,396,190.840437991886,173.641762093641
"3411",485,86,399,205.012109257506,180.15830500319
"3412",475,87,388,194.114546636655,182.21380043256
"3413",465,84,381,190.008581571138,173.504551816154
"3414",471,81,390,182.256076685259,176.081077086864
"3415",487,87,400,188.540253792807,182.942671377661
"3416",485,95,390,197.794108407671,180.165352318354
"3417",486,85,401,194.065727716831,176.598968083657
"3418",482,87,395,188.565611537125,178.359394262508
"3419",487,82,405,183.804316281081,172.249186462701
"3420",491,88,403,198.087133809898,170.327122066979
"3421",492,77,415,212.209131183927,178.779937145474
"3422",482,84,398,190.636522140787,180.819843109812
"3423",490,90,400,190.308755122537,177.995295506155
"3424",463,75,388,206.720740386409,180.049365448771
"3425",491,92,399,183.566888862095,178.144334545258
"3426",489,85,404,182.361410079492,175.515981961234
"3427",491,85,406,197.946338790985,170.008057293802
"3428",473,85,388,197.264068684775,178.599035451501
"3429",487,86,401,188.272118226046,169.42463842009
"3430",476,82,394,183.911850875766,177.238755041446
"3431",476,80,396,193.678327395329,184.456676239246
"3432",487,92,395,183.530017100121,177.950088672371
"3433",500,89,411,204.083335436153,174.878652175846
"3434",477,88,389,196.059250537309,175.051143647859
"3435",493,83,410,194.63861838541,176.795429340747
"3436",484,77,407,193.024888670686,169.11212390074
"3437",478,84,394,187.170993300722,182.763765342613
"3438",479,80,399,197.265805668712,173.488893517007
"3439",498,85,413,189.71888641017,178.689801913872
"3440",496,92,404,206.336694688948,174.295037329204
"3441",481,90,391,196.694907393542,176.736469372754
"3442",485,89,396,190.61823281948,177.48129232839
"3443",467,88,379,195.730556554697,179.344942654983
"3444",477,81,396,205.490902649376,180.015442829171
"3445",488,92,396,206.287011230252,178.353202872195
"3446",503,90,413,195.920921524467,176.096143966997
"3447",478,86,392,200.448627143532,178.997218742135
"3448",478,87,391,201.778632045203,178.07426157034
"3449",494,80,414,195.082376334117,178.786666368162
"3450",487,87,400,211.396577554217,179.893559743787
"3451",489,90,399,197.599649685647,175.409693813719
"3452",491,88,403,186.324263659202,176.645505772562
"3453",481,93,388,193.967291105565,180.450301363652
"3454",500,93,407,191.966228230796,181.609113140288
"3455",490,81,409,191.538733923056,173.73674268337
"3456",472,82,390,209.179243809319,174.446505532739
"3457",481,86,395,175.424431561591,174.01385052293
"3458",491,86,405,195.767123902718,178.602461910223
"3459",487,90,397,205.527851436614,176.247625004914
"3460",490,89,401,191.219872670862,174.998951209462
"3461",485,91,394,193.222218732154,171.229231550068
"3462",496,93,403,194.947132093999,180.630215358175
"3463",461,81,380,202.147626575329,181.39472380425
"3464",481,86,395,228.007528908069,175.105497790436
"3465",489,91,398,189.462980655183,174.60430505031
"3466",483,91,392,206.626677332038,182.53747424393
"3467",498,94,404,206.122348183535,174.3827195934
"3468",485,83,402,196.896014844756,173.241946864266
"3469",478,82,396,201.967717943693,179.732860932787
"3470",486,87,399,191.007424708582,178.499810896308
"3471",477,83,394,200.678432391641,179.905452969448
"3472",487,92,395,197.967793549864,174.552609637645
"3473",488,91,397,192.235452435299,177.169566955296
"3474",494,85,409,205.32166518573,175.47631758626
"3475",493,84,409,197.499939088502,180.507012539778
"3476",490,83,407,189.360081664664,177.044228537865
"3477",482,83,399,193.943539605186,178.05091392475
"3478",483,88,395,197.139205157879,172.794090678346
"3479",474,84,390,196.385538228091,173.878962034949
"3480",491,82,409,193.216432514117,177.93191272269
"3481",492,91,401,190.359249266071,176.058011794484
"3482",474,86,388,194.891858159746,177.885165222315
"3483",488,81,407,194.205944492401,177.317306216661
"3484",489,84,405,189.154703484487,178.019916173279
"3485",484,92,392,197.259128755173,179.374629791459
"3486",484,81,403,196.5711314996,175.638595013257
"3487",491,91,400,188.263074501955,175.039124742535
"3488",486,78,408,189.726058069724,183.367190725084
"3489",487,82,405,197.209381387203,179.638351230382
"3490",489,92,397,198.021053935087,173.746890650728
"3491",481,81,400,207.341501658161,176.814455953634
"3492",502,90,412,184.266584171413,173.361681827722
"3493",482,82,400,201.564135589672,175.786313170515
"3494",482,81,401,202.471136761749,175.833013048427
"3495",486,82,404,186.704515579218,179.161433276055
"3496",481,82,399,204.504614320759,182.598014630859
"3497",466,89,377,197.331208861452,181.255808702597
"3498",471,84,387,201.681283516291,177.681740870585
"3499",483,87,396,203.769629412967,180.252232986818
"3500",480,86,394,202.79634601186,176.364310131896
"3501",489,86,403,185.124179930906,175.770836475373
"3502",480,89,391,190.708554659913,177.440645939163
"3503",485,87,398,189.248022200161,168.55706626097
"3504",493,89,404,192.001108393375,181.75566550306
"3505",483,87,396,191.599708073695,171.567347341238
"3506",484,84,400,184.741081299708,175.474280640139
"3507",477,88,389,190.067498932152,169.89259927701
"3508",490,86,404,198.886738465751,172.990935136589
"3509",466,84,382,198.4817373363,175.555001852318
"3510",491,100,391,200.512941583586,185.45506499078
"3511",504,89,415,189.87817229132,171.258487014882
"3512",486,86,400,190.221037134715,173.324434992085
"3513",483,90,393,185.948874923246,181.260108535774
"3514",486,91,395,191.049807901693,175.353463771441
"3515",496,82,414,190.950897784047,178.513792422696
"3516",476,84,392,200.628102722883,174.57154737848
"3517",483,79,404,188.789093887076,178.778231722791
"3518",483,82,401,203.571413419543,170.968887084247
"3519",474,87,387,202.038436464183,176.351069737477
"3520",481,84,397,198.299029673233,175.982303135588
"3521",482,77,405,194.692973207266,178.248829403517
"3522",486,85,401,192.233992933062,181.086245621158
"3523",472,72,400,198.959519667721,182.8428632691
"3524",474,81,393,201.515042293898,172.990754545429
"3525",482,82,400,196.16148924571,176.654125006306
"3526",480,77,403,202.442537593153,175.059496104372
"3527",508,87,421,183.122796820176,171.099170651566
"3528",472,83,389,208.352042100464,174.598171208843
"3529",492,91,401,195.483210466271,179.345503959502
"3530",483,92,391,179.767397158098,172.413360740009
"3531",472,84,388,196.417156650567,174.878797450999
"3532",500,96,404,192.013608733227,176.755118407156
"3533",494,89,405,192.774522017318,174.047946575936
"3534",476,83,393,188.768143312971,177.280715257344
"3535",467,91,376,203.044439156326,178.405519261231
"3536",494,87,407,197.995586266932,183.929528184917
"3537",486,83,403,185.868574327454,186.984643557927
"3538",492,83,409,188.496537792931,171.369806582771
"3539",467,83,384,190.934820319914,177.306099289186
"3540",489,90,399,195.622683675404,171.309252951305
"3541",481,85,396,201.194548723851,176.765567419639
"3542",503,83,420,186.816571889555,176.40361765659
"3543",488,91,397,194.555305605532,173.962038407942
"3544",475,76,399,184.560453249679,176.473743035946
"3545",486,92,394,207.857003650299,176.56292466007
"3546",462,83,379,209.845588156288,179.507302735772
"3547",480,81,399,206.472064006742,177.769091266923
"3548",473,88,385,203.061968989001,178.591744391917
"3549",469,80,389,200.121195751948,175.482932319048
"3550",469,88,381,200.683483516382,180.45577235288
"3551",488,87,401,189.981534076642,177.515104740325
"3552",494,84,410,175.234671555967,172.158848957126
"3553",482,83,399,188.871647514501,179.830585775194
"3554",473,85,388,204.4215136125,172.789865501871
"3555",489,83,406,210.187993880389,179.312648023933
"3556",477,83,394,201.768905990249,171.663461513696
"3557",474,87,387,185.816266008726,173.68118269498
"3558",490,89,401,183.612626196727,177.631438118392
"3559",491,82,409,194.093426643126,175.397800987862
"3560",480,85,395,198.93303755386,174.1332855027
"3561",488,93,395,190.239280263931,175.995245756417
"3562",475,78,397,192.651400727871,177.900695599055
"3563",480,81,399,205.618414168043,174.944253638045
"3564",473,79,394,193.553219663284,172.401339052764
"3565",466,91,375,193.224415314603,173.497422231416
"3566",475,79,396,188.856518662974,173.287572033672
"3567",487,89,398,187.53559789904,179.666638224267
"3568",501,93,408,191.854642130837,178.758026962922
"3569",483,88,395,185.681163059719,178.369926525839
"3570",478,84,394,202.219526968235,179.052221404294
"3571",493,83,410,206.652755499942,182.475222056184
"3572",480,85,395,198.737672494862,178.24779770273
"3573",487,85,402,190.570644296745,175.126284743103
"3574",483,91,392,189.949309948877,178.86442054112
"3575",488,101,387,194.099678162703,174.802786743229
"3576",463,81,382,208.672972484042,174.730847116747
"3577",484,81,403,197.379804576875,176.897442523206
"3578",464,81,383,203.897830865674,179.228385789939
"3579",462,80,382,193.82149688608,179.608473580053
"3580",476,82,394,203.056158344469,179.831927248114
"3581",481,88,393,191.800942850047,173.010025203992
"3582",484,85,399,183.44140761356,177.252485164267
"3583",486,86,400,195.576488202666,173.453741808054
"3584",487,84,403,198.662286275889,176.371220422579
"3585",470,83,387,203.662226915297,176.824750592328
"3586",476,84,392,191.413773369319,180.181908926436
"3587",480,87,393,197.361792869744,172.058622197231
"3588",469,86,383,211.427759668179,178.447737564493
"3589",474,84,390,194.62353975956,177.216731372494
"3590",475,84,391,190.919330618,175.907301876051
"3591",470,81,389,197.329438446891,169.840636662536
"3592",481,83,398,193.313660804782,175.185989589367
"3593",481,84,397,204.370189826222,180.990653055971
"3594",489,85,404,201.049859398197,175.093204199751
"3595",498,86,412,193.978536695045,170.815480811017
"3596",488,86,402,196.762185156122,177.067054108621
"3597",493,85,408,191.611422019023,181.480146434933
"3598",488,88,400,199.483735721453,173.605581566416
"3599",490,88,402,203.908719501544,174.199998949041
"3600",486,83,403,197.097251115473,170.854109655051
"3601",473,83,390,203.203157617089,180.021930855376
"3602",486,86,400,201.523571783616,173.275684728642
"3603",487,85,402,199.859882598317,180.149295661567
"3604",487,80,407,196.792607911603,179.84771418546
"3605",476,75,401,196.584370140761,174.462427725892
"3606",497,82,415,199.569337449181,181.588187373071
"3607",493,84,409,194.916377525798,177.506236030622
"3608",492,87,405,206.250023568693,174.435912084222
"3609",476,77,399,201.350210617866,171.834455368268
"3610",503,87,416,185.890588299562,176.207289720036
"3611",477,82,395,191.79153794084,181.991519291044
"3612",482,85,397,188.998448193327,178.400006157122
"3613",490,91,399,184.49421273893,179.571677037614
"3614",475,82,393,202.736867520086,171.985976908494
"3615",503,98,405,208.268702531276,182.047462912138
"3616",491,84,407,194.513533179821,182.231722803075
"3617",487,86,401,217.723102380973,176.27421401271
"3618",486,89,397,192.505315224948,175.447404915712
"3619",479,89,390,195.033147546599,175.912069816818
"3620",476,82,394,187.253940023026,175.226395519502
"3621",486,87,399,201.187082640373,173.186121685342
"3622",494,93,401,191.257192969823,176.304141781422
"3623",486,91,395,195.025724916267,177.278028303787
"3624",471,78,393,208.360499548194,177.777514688669
"3625",480,78,402,195.347544565687,177.372516425533
"3626",464,85,379,197.955242041922,181.640232538224
"3627",480,83,397,201.428047603026,177.24359036829
"3628",484,95,389,191.993294322496,178.760664062095
"3629",478,87,391,200.174999755435,173.245785479051
"3630",485,82,403,189.198645176061,179.506992437045
"3631",497,93,404,192.602975005278,172.433619646733
"3632",486,86,400,196.594343544063,177.926182760234
"3633",477,82,395,194.11203937568,183.309311305931
"3634",473,88,385,200.821006603658,170.786310167807
"3635",477,86,391,190.299452441504,178.557345974518
"3636",487,89,398,191.776110838236,171.910520335943
"3637",471,81,390,198.189577325243,179.509794796364
"3638",478,85,393,201.64002014882,178.724893768434
"3639",499,92,407,192.868137643713,172.414372437014
"3640",464,79,385,193.502766269307,170.771146087623
"3641",467,76,391,214.507137003701,177.634947676805
"3642",500,81,419,203.991169382473,176.837052767151
"3643",492,91,401,196.409781573782,179.023423693302
"3644",490,88,402,198.76421243449,176.709053993323
"3645",499,83,416,196.336318390266,179.310073377701
"3646",471,84,387,204.888125974616,181.085000743997
"3647",486,88,398,186.125740950184,175.675604900614
"3648",483,75,408,186.560023029205,175.306182449833
"3649",490,83,407,206.65687363187,175.300499057596
"3650",486,85,401,196.042528164371,177.882381738298
"3651",494,77,417,201.136910962866,179.870379751248
"3652",479,81,398,180.274446498785,179.016866714471
"3653",481,79,402,192.891956396035,177.177903463936
"3654",499,87,412,196.391656665373,180.686351041094
"3655",466,82,384,187.906610255506,178.37501306479
"3656",466,86,380,194.323444018537,174.497229248433
"3657",479,84,395,198.313268353929,175.834931482517
"3658",466,77,389,196.709817889994,180.220844139929
"3659",465,85,380,193.287439031866,171.171701217245
"3660",481,86,395,207.534339519872,182.212025956024
"3661",481,92,389,186.191096359678,173.613072594943
"3662",489,84,405,186.684011457307,175.978085306259
"3663",470,85,385,192.671531187888,175.159526062429
"3664",487,85,402,198.487972167345,172.625533160395
"3665",484,83,401,200.916511519804,168.080629956117
"3666",483,95,388,201.798121987308,178.950652239664
"3667",474,80,394,198.158494631252,180.745204292563
"3668",494,81,413,193.533954337996,173.165933347305
"3669",476,86,390,191.204644055067,177.125495739928
"3670",481,82,399,196.732864822891,176.972988025582
"3671",481,88,393,201.237503900037,173.939315247839
"3672",479,83,396,219.501416462312,177.621779890736
"3673",498,86,412,203.157069067898,179.130710929784
"3674",477,81,396,195.4422477732,175.540337614978
"3675",473,86,387,190.547410520864,178.390801866116
"3676",488,86,402,193.657198800231,184.843712201403
"3677",483,79,404,189.911468293793,177.408114478755
"3678",463,81,382,195.362932363418,171.334632471544
"3679",490,90,400,200.038849785066,174.245174935631
"3680",494,76,418,211.204611267534,177.328949643113
"3681",483,84,399,183.066873942085,179.177038480318
"3682",487,81,406,194.514058805062,177.887876439362
"3683",488,96,392,196.157691703887,184.493370317994
"3684",483,91,392,199.624706141702,172.231019296072
"3685",494,76,418,193.985725062637,174.420838931922
"3686",491,88,403,199.529201185477,176.593729630969
"3687",482,91,391,195.78664249731,172.260137911545
"3688",488,86,402,185.318074145539,180.362678585623
"3689",495,86,409,197.084876600277,187.300987087999
"3690",470,88,382,193.930749573902,172.292091053005
"3691",469,82,387,202.161103467296,173.965694473897
"3692",478,87,391,195.584166168163,171.084731342149
"3693",482,91,391,197.770345180489,172.569209142622
"3694",486,86,400,183.925565017937,179.850937266184
"3695",493,82,411,198.517258696852,176.261538822237
"3696",506,89,417,210.576612974552,174.428611650746
"3697",488,86,402,197.801622348133,174.702641686426
"3698",482,83,399,191.836299610477,179.327056400777
"3699",496,77,419,204.157102465948,175.633027524731
"3700",478,84,394,192.480027627593,172.074466162521
"3701",469,87,382,192.869261045128,178.14752762696
"3702",485,84,401,189.078264725836,173.940309168892
"3703",481,76,405,201.97372123064,173.687732306116
"3704",473,75,398,211.574482967179,178.156720990819
"3705",482,89,393,197.524098264422,179.395010855387
"3706",481,83,398,195.366431826949,181.872373116678
"3707",484,87,397,200.39178037038,173.336190378921
"3708",501,90,411,210.580494827151,173.885491227467
"3709",487,83,404,210.408957659446,174.523840494175
"3710",496,82,414,184.218022556996,175.776018770569
"3711",459,82,377,189.519656399316,176.655823479967
"3712",481,87,394,197.149220941684,175.477282434036
"3713",489,87,402,189.227603914102,175.254140224549
"3714",485,83,402,189.76517958754,176.535355982921
"3715",484,86,398,204.939889100576,180.53007894592
"3716",482,85,397,205.876421020372,183.495430956114
"3717",477,83,394,191.908673798526,178.423695706456
"3718",494,86,408,192.00103638722,173.533239158932
"3719",479,81,398,203.3178114194,175.598819148634
"3720",492,85,407,186.058201856329,178.161743020703
"3721",496,87,409,192.406275270466,177.664531582854
"3722",493,87,406,187.993370939759,174.041509028754
"3723",478,81,397,201.192057294285,172.417390431737
"3724",513,89,424,201.605955721678,183.186891597967
"3725",489,80,409,197.93124725762,171.269717450597
"3726",497,85,412,192.935570783351,179.047829791136
"3727",484,92,392,197.644264760397,173.686946530547
"3728",469,79,390,194.390338020265,175.237756014715
"3729",488,86,402,207.112376692104,172.805368181933
"3730",481,82,399,180.822249133339,178.91278262354
"3731",509,99,410,185.140878747664,182.80994534371
"3732",491,87,404,201.957850257947,177.939645486681
"3733",473,80,393,190.15284754395,169.636083954678
"3734",491,86,405,180.043669039166,182.382550658345
"3735",488,83,405,195.144560544761,177.020904897179
"3736",476,77,399,195.855146008489,175.891696166366
"3737",493,85,408,191.060198611199,175.737335756681
"3738",499,90,409,193.94537398957,184.327417821609
"3739",475,89,386,196.619599105608,174.22367876184
"3740",487,90,397,179.590669349235,177.15805784363
"3741",480,91,389,184.737005453594,176.041848226683
"3742",487,88,399,191.626047810488,172.198658760101
"3743",487,86,401,187.671749808995,173.717137512515
"3744",489,83,406,197.897836127473,173.884374696539
"3745",493,82,411,182.861790654622,180.72794473798
"3746",480,90,390,212.854190379964,172.10411182754
"3747",464,87,377,209.428669918505,178.779555179977
"3748",488,88,400,193.946933731311,175.172294908592
"3749",480,82,398,208.854154101282,173.305810340427
"3750",492,87,405,201.421457300285,175.491130871004
"3751",482,92,390,201.024386915751,179.99350904887
"3752",458,82,376,214.825621759811,176.985248391257
"3753",465,81,384,200.61377290862,171.199824291676
"3754",485,85,400,208.198798162954,173.007598127831
"3755",493,87,406,196.864906100828,178.148879268031
"3756",488,81,407,203.646659297194,180.194944373299
"3757",464,88,376,182.769842951457,175.074746927494
"3758",476,75,401,204.552417054519,177.03687094385
"3759",481,85,396,193.342712473945,173.697661421192
"3760",495,88,407,194.086431634795,183.742096805417
"3761",489,83,406,195.626174764468,179.39140025913
"3762",495,98,397,180.709766996434,184.090548463215
"3763",485,83,402,178.703624030193,180.231239959223
"3764",480,86,394,202.965949463221,176.612817175286
"3765",502,91,411,185.256268243932,172.274622084118
"3766",481,83,398,178.135259624573,173.623430348687
"3767",480,83,397,203.789833175551,179.336640482961
"3768",489,81,408,186.472700558704,177.010148941949
"3769",491,92,399,190.581972671022,186.914002088192
"3770",494,88,406,202.961304316523,175.341006855078
"3771",490,87,403,189.543864335018,182.299056461547
"3772",497,92,405,195.686077916109,177.033876806704
"3773",472,88,384,193.103386324356,173.867081297278
"3774",489,93,396,182.29113305494,170.753402810823
"3775",480,83,397,192.313676961003,166.36893978084
"3776",483,92,391,194.432868823159,180.536569238507
"3777",473,84,389,206.565864721708,186.309999162688
"3778",496,86,410,196.332452433431,177.062193852068
"3779",493,91,402,197.31550398165,177.145312426199
"3780",501,89,412,196.241454294395,175.507986986198
"3781",481,87,394,201.494033659168,174.134071406075
"3782",490,82,408,194.985932638591,176.182202980723
"3783",483,86,397,193.070397637883,177.254826087127
"3784",482,81,401,197.66413797294,172.524245122999
"3785",479,86,393,192.994061319469,179.362914636004
"3786",490,85,405,206.165098793285,176.111216464317
"3787",504,85,419,196.273244716199,171.301500309906
"3788",491,90,401,194.696518795885,178.240868275703
"3789",484,93,391,184.583639662565,174.203946336873
"3790",488,84,404,205.434473230669,178.321969139227
"3791",491,85,406,199.700150385953,174.779776857525
"3792",469,82,387,195.813775884679,178.099064894446
"3793",468,90,378,201.601193650646,174.406936570514
"3794",489,83,406,188.438422657068,182.463194973131
"3795",477,81,396,189.271296273446,177.849933182768
"3796",478,86,392,200.447352785669,178.159820494532
"3797",503,85,418,185.972221620772,175.965977102472
"3798",480,82,398,185.763356493378,178.860851358543
"3799",486,79,407,200.907798652836,169.892855175706
"3800",495,89,406,184.452093662056,179.884132399326
"3801",485,89,396,203.730652052722,169.523463255817
"3802",493,96,397,173.998595013664,177.519500085967
"3803",481,80,401,185.570898557981,176.305988862799
"3804",487,94,393,189.383026827016,176.993821312268
"3805",491,93,398,200.822636424796,176.31753261401
"3806",481,88,393,181.65363896683,173.205266322633
"3807",482,86,396,198.476358625023,176.253632433925
"3808",486,81,405,199.167778786303,181.075410895568
"3809",479,80,399,206.019144857098,176.703222533498
"3810",492,85,407,185.817134126221,173.191731625751
"3811",491,84,407,199.289570269111,176.908412878431
"3812",472,82,390,208.026170133099,176.022189645899
"3813",481,85,396,193.147887740665,175.780450690918
"3814",483,85,398,207.552174415938,179.681447023223
"3815",489,84,405,204.574177641736,182.659922229124
"3816",495,87,408,197.158498382767,176.026844294837
"3817",494,106,388,186.768060271302,179.505326768311
"3818",479,90,389,196.649804105994,174.709305406288
"3819",495,73,422,201.849762217807,178.912835292252
"3820",481,79,402,194.616708691192,178.350626386967
"3821",484,84,400,194.023955763593,186.423244978657
"3822",480,88,392,187.538062875904,178.070473537312
"3823",491,87,404,191.72736796199,182.933634498996
"3824",501,92,409,204.04207055155,176.849489579019
"3825",487,89,398,198.668803121927,175.242304429565
"3826",484,81,403,190.388412125522,182.525671712776
"3827",502,86,416,206.189169907331,178.885193872177
"3828",494,82,412,192.633988669915,175.655662733052
"3829",490,84,406,206.991991835664,176.300006814927
"3830",474,80,394,187.498041209405,175.181231029446
"3831",480,88,392,207.72224818751,179.76392690537
"3832",465,83,382,197.556879227577,177.410203286378
"3833",472,80,392,186.786289583923,182.584754860148
"3834",488,82,406,190.62903684766,174.976674573357
"3835",478,88,390,199.694546116228,183.035247101638
"3836",493,89,404,204.304564427089,176.687535106373
"3837",487,91,396,188.066269118894,173.6450221195
"3838",479,86,393,206.047521101023,172.035138979973
"3839",494,85,409,204.481625814942,174.567704032584
"3840",473,86,387,203.772898654607,180.904365732802
"3841",498,85,413,203.742578134271,181.852059360915
"3842",487,93,394,195.331297898655,173.05467194059
"3843",483,85,398,198.246682228493,176.422225643128
"3844",480,81,399,199.595282490883,178.494413510579
"3845",473,83,390,186.229856522219,177.964636436496
"3846",494,83,411,199.086129666284,173.709582447016
"3847",482,72,410,195.972081063441,174.552834697841
"3848",498,91,407,196.650821641635,174.900767934329
"3849",485,93,392,202.435900070092,179.655381854709
"3850",489,89,400,182.240719877491,174.903480290435
"3851",480,86,394,190.731220011817,173.04795992021
"3852",484,84,400,182.222684257237,178.006105006643
"3853",478,86,392,193.859713276395,178.112236377642
"3854",483,83,400,209.715925035969,178.790169284558
"3855",487,87,400,194.750386673018,180.079135524937
"3856",481,86,395,193.502879350502,179.130422214586
"3857",493,92,401,180.673766891084,172.858138960546
"3858",464,78,386,199.092604072169,173.691529823551
"3859",480,81,399,193.480890959491,182.271320857605
"3860",479,83,396,204.748524668982,178.095239770223
"3861",468,89,379,190.582170081241,169.982585885799
"3862",482,82,400,192.494019651158,181.652192608942
"3863",481,82,399,203.31284416419,178.98484042481
"3864",492,82,410,199.795000484999,179.879290966025
"3865",478,88,390,213.43964239914,180.294152584205
"3866",492,76,416,192.444144941806,174.13249899662
"3867",473,85,388,189.798770059436,179.461350735668
"3868",496,88,408,194.321803326113,176.816060007502
"3869",474,90,384,194.780349589834,178.37641791488
"3870",476,96,380,187.978371134268,177.730522549771
"3871",476,86,390,195.355149203859,176.278227163857
"3872",479,83,396,189.17469370282,177.161754848024
"3873",494,83,411,197.507583042391,179.453107435677
"3874",476,81,395,206.400186221665,177.861316283629
"3875",469,80,389,209.65708740347,176.067798542765
"3876",486,85,401,186.586100137508,178.960531614619
"3877",493,91,402,204.911662417924,180.592113101241
"3878",482,84,398,204.690589043556,176.89770824841
"3879",494,84,410,188.903428891309,173.522624030367
"3880",484,87,397,200.106047104167,180.016296591167
"3881",486,93,393,193.011408588967,173.307559867217
"3882",495,83,412,199.0722926069,170.676612770984
"3883",493,87,406,194.936397359335,181.105595079444
"3884",498,89,409,194.635538139201,173.745071634042
"3885",478,86,392,195.898383570494,178.824516150838
"3886",472,84,388,196.157380005515,178.568918512458
"3887",479,82,397,189.75311436009,179.533585553263
"3888",487,86,401,192.316907047773,178.670091715259
"3889",481,85,396,186.271329313075,172.433146045903
"3890",487,84,403,198.19876050573,182.526882984764
"3891",489,88,401,196.616060590818,177.077210860451
"3892",458,80,378,204.548862687193,182.697959210374
"3893",484,80,404,200.652702857096,177.312028459624
"3894",492,92,400,200.289040327468,178.997760573782
"3895",494,86,408,191.796631553701,174.017251071953
"3896",498,92,406,193.584994905861,177.519873987723
"3897",488,84,404,209.039661927843,171.668675640443
"3898",487,77,410,207.222085567934,171.030436530421
"3899",483,83,400,180.55776164986,176.390697722642
"3900",489,84,405,197.226647122486,182.779154283554
"3901",493,93,400,198.316067605329,177.297898615753
"3902",482,74,408,205.055012024427,186.564815752866
"3903",484,77,407,188.987673792506,179.962519517677
"3904",471,78,393,196.320678366311,173.438155519428
"3905",471,86,385,202.298695834536,176.570150434067
"3906",473,87,386,185.757064901383,177.852206349075
"3907",475,83,392,202.862158190583,172.453098390387
"3908",491,85,406,202.667538852162,180.369588918543
"3909",481,85,396,197.404325447293,178.822267277114
"3910",493,83,410,193.717422045996,179.198349332061
"3911",478,86,392,193.579189717423,176.978606314468
"3912",481,85,396,204.077567297163,180.957678958343
"3913",492,81,411,191.907102414538,184.883371906631
"3914",498,88,410,193.16005698545,174.801614577911
"3915",474,89,385,186.881535057112,179.973444267665
"3916",481,84,397,201.998961547091,174.827034162989
"3917",482,95,387,194.304031371448,179.025877460071
"3918",498,91,407,190.786711242211,172.307243692502
"3919",502,94,408,192.506347502192,179.432916868879
"3920",482,77,405,197.05561193198,173.971624757057
"3921",490,90,400,187.094382663963,175.31720609735
"3922",485,85,400,199.430714476003,181.239078201841
"3923",476,85,391,196.334642776585,177.841030876183
"3924",498,82,416,198.164341593379,178.812924715414
"3925",513,89,424,188.575376938017,180.395367772667
"3926",485,82,403,188.276328492525,180.78672501354
"3927",477,81,396,202.855764671917,179.684294293693
"3928",489,93,396,203.739874039141,175.01368068256
"3929",468,80,388,194.815725233206,178.75249494447
"3930",496,88,408,197.796035782343,179.046775256873
"3931",499,83,416,186.799591810592,179.836047717556
"3932",493,89,404,196.396997732726,178.651036003914
"3933",466,80,386,190.654738255696,175.816405373807
"3934",480,84,396,188.882103533378,174.229727893292
"3935",478,84,394,190.302575765285,178.007081582709
"3936",482,86,396,188.300642719713,179.247760010901
"3937",520,86,434,196.484149474676,175.954895213409
"3938",480,82,398,184.658697267487,172.892145939943
"3939",490,90,400,192.374394697944,178.169234612435
"3940",498,93,405,182.368448131652,179.077467573982
"3941",475,81,394,192.45051179849,181.882919640913
"3942",467,90,377,184.937449409056,182.339157623987
"3943",483,89,394,195.228253492977,180.37838893158
"3944",485,89,396,189.930894739284,171.771125977178
"3945",461,81,380,212.495797854588,176.780545465737
"3946",488,86,402,188.024940882276,178.859317629515
"3947",484,80,404,197.566269037542,173.17583961487
"3948",476,90,386,189.901962175931,178.706446636202
"3949",496,83,413,202.023184110181,179.212873702756
"3950",474,89,385,198.219743183456,172.449336502762
"3951",461,78,383,188.901212223036,178.033600371738
"3952",495,80,415,189.967965206316,171.833790511367
"3953",473,91,382,184.720893723915,167.41759650485
"3954",490,79,411,205.145574634904,176.044900942987
"3955",502,79,423,179.38755369125,172.78965205473
"3956",465,81,384,207.077834905109,185.440127597441
"3957",484,83,401,192.222693865526,175.542587753873
"3958",499,88,411,204.966615245086,178.335908306075
"3959",488,98,390,192.299589685192,181.864845596982
"3960",470,83,387,203.217468831845,177.659347085517
"3961",472,83,389,201.17444418313,171.453654905929
"3962",480,75,405,192.860269403059,177.214413266936
"3963",475,81,394,199.909510186875,171.315865790168
"3964",492,89,403,190.595221399323,180.090302577441
"3965",471,88,383,203.340182243066,177.323731064809
"3966",475,84,391,199.418129276082,173.75200023795
"3967",483,83,400,203.854712858596,166.750673449146
"3968",489,82,407,196.932908433812,178.741616626614
"3969",483,85,398,193.919328255911,183.766958137565
"3970",474,84,390,193.222442066561,177.239500913267
"3971",487,77,410,203.702748191253,175.134933490861
"3972",495,98,397,196.814500853745,179.301013417371
"3973",477,82,395,185.512236610675,172.771970335539
"3974",493,89,404,198.792052541743,177.068580781751
"3975",473,80,393,193.611671351233,172.499133374121
"3976",497,84,413,199.576260363083,181.887509797897
"3977",478,91,387,194.388793182136,176.80639474428
"3978",470,81,389,186.630686550396,174.378362354884
"3979",482,83,399,188.737856888263,183.889966371318
"3980",488,85,403,201.066195362113,174.076972880041
"3981",490,93,397,196.425409211616,179.610390344364
"3982",491,92,399,200.089116172963,178.480628760562
"3983",478,81,397,190.483917489606,171.537646782896
"3984",477,82,395,195.193344695091,177.73648464309
"3985",474,82,392,190.992664703883,173.105002192549
"3986",495,87,408,202.966844625516,178.064219366084
"3987",469,78,391,195.672753929018,178.873887543257
"3988",478,94,384,204.819145646356,177.644940516515
"3989",474,72,402,209.720350891025,178.40916151518
"3990",479,85,394,189.742025420418,171.67127023115
"3991",504,93,411,194.378235969753,172.308941518836
"3992",473,79,394,196.096012885527,179.757715514615
"3993",489,91,398,194.227166077364,176.872437091457
"3994",476,80,396,190.488182633015,175.247977114377
"3995",504,96,408,187.44739432539,179.079623280089
"3996",492,81,411,193.46391478591,171.580599447666
"3997",486,86,400,198.863389954819,181.202890073602
"3998",480,85,395,197.914554968004,172.840506756752
"3999",489,87,402,189.321385860775,175.336118205548
"4000",491,92,399,199.876651552439,174.952142802939
"4001",485,91,394,194.083638268486,174.514824890975
"4002",488,87,401,202.797758105531,173.046701976786
"4003",469,86,383,201.329670385899,174.001645518781
"4004",484,75,409,206.261944659498,173.873678639495
"4005",482,83,399,183.732644839017,180.989554696429
"4006",472,80,392,175.922790113781,170.454035202381
"4007",479,83,396,194.123566228283,180.959383916456
"4008",475,82,393,198.848674139092,176.300304435293
"4009",476,86,390,193.371628625972,177.781147946402
"4010",485,83,402,196.126455705318,173.440705096076
"4011",500,98,402,183.33474100731,175.886938443129
"4012",494,88,406,190.34084609415,174.921498939085
"4013",491,103,388,194.700299936341,181.880624217408
"4014",483,80,403,177.070050516491,171.781759356419
"4015",481,89,392,201.948614206351,180.129714225026
"4016",474,88,386,204.915450372297,174.643404386474
"4017",481,87,394,193.435238677712,182.736839615106
"4018",469,83,386,194.364134662821,178.870808085604
"4019",477,79,398,205.092755538628,179.844434062282
"4020",494,84,410,181.755647831612,183.844635105346
"4021",476,84,392,199.561797290091,176.284009751516
"4022",484,87,397,182.238376263002,176.150703675764
"4023",492,93,399,199.427089958769,178.36099448028
"4024",481,92,389,200.228396831177,186.218249441261
"4025",481,86,395,199.665597245157,178.134078730495
"4026",488,89,399,204.125194418644,180.695357904814
"4027",477,85,392,197.730876689756,178.400829229787
"4028",481,87,394,196.983381225428,175.249778221798
"4029",474,94,380,201.689796005818,173.813563352145
"4030",477,83,394,186.807151334197,180.114438614208
"4031",494,81,413,201.781041939268,184.240778136508
"4032",489,91,398,189.105242341619,178.460755138562
"4033",481,81,400,201.803109043528,179.471760197932
"4034",480,84,396,188.107062434772,178.480876573469
"4035",500,86,414,194.982088288181,180.323068661503
"4036",470,86,384,190.183159181082,178.288178755684
"4037",488,83,405,197.407949376999,179.179818370214
"4038",482,80,402,190.292162015718,170.47231347309
"4039",487,90,397,191.483625987833,167.802726742873
"4040",485,87,398,196.340418537976,167.662398816607
"4041",469,79,390,199.360064752342,177.093959303433
"4042",479,85,394,193.313771089848,175.25881157527
"4043",493,85,408,198.228759395197,173.903551408009
"4044",490,88,402,186.510436028003,174.100034365002
"4045",481,84,397,182.907831310026,183.120325404806
"4046",493,90,403,208.892410823553,179.814529832099
"4047",493,91,402,197.837382058367,172.989895622645
"4048",483,83,400,204.349987876131,176.008516498519
"4049",477,76,401,200.683837356416,177.549967479567
"4050",481,89,392,185.144775586089,175.339366298788
"4051",492,79,413,193.313548229178,175.298630828916
"4052",478,87,391,178.163959406033,174.699799872987
"4053",477,83,394,203.110736434775,174.661768768465
"4054",482,83,399,190.804173147126,173.205422615949
"4055",507,92,415,192.494854096475,177.207213041017
"4056",478,85,393,200.389815163314,169.641467160268
"4057",487,91,396,184.793574798373,172.266123595782
"4058",476,87,389,192.673674146987,177.007235546394
"4059",478,82,396,193.977503788065,173.22377462168
"4060",486,87,399,188.778846753263,176.608708173008
"4061",488,88,400,193.189567940616,179.04156323922
"4062",481,85,396,203.188713616923,179.752846635715
"4063",493,83,410,184.482914058716,177.424250779593
"4064",489,89,400,203.319537258991,181.819243171389
"4065",480,80,400,205.890063923795,180.290286341157
"4066",481,77,404,195.629505284124,182.915098789472
"4067",509,91,418,194.326511276246,183.333894939116
"4068",516,90,426,187.195565772053,179.177538945335
"4069",472,84,388,203.267663932872,171.505115404444
"4070",502,85,417,196.724534125445,174.804138567438
"4071",483,90,393,202.622916207934,175.958330380873
"4072",486,83,403,188.249673966555,175.993061676416
"4073",477,79,398,207.896807896973,173.703444426858
"4074",486,79,407,202.000147966812,178.601605409655
"4075",485,85,400,186.329588964549,178.88178696903
"4076",487,87,400,193.217621427331,178.824851272602
"4077",495,87,408,196.246663927027,175.98734615986
"4078",476,78,398,194.155729021187,179.227403248575
"4079",487,80,407,196.937632165854,175.524521420034
"4080",492,85,407,193.512321807013,177.592534901897
"4081",490,96,394,192.849267623177,172.9467179697
"4082",477,82,395,181.622402824337,177.251348958543
"4083",502,93,409,186.272692295064,174.471548843568
"4084",489,92,397,202.6721605249,177.499122051618
"4085",494,96,398,198.985496406934,171.694800110996
"4086",482,83,399,195.026200048842,174.661086543747
"4087",474,83,391,202.381588238916,178.129774652995
"4088",476,88,388,194.186341493769,177.233421445189
"4089",489,89,400,205.231691950188,175.069383264724
"4090",479,83,396,188.302017068042,173.631135773465
"4091",485,88,397,194.503424368977,182.967466449349
"4092",486,88,398,202.768589508407,172.50733983028
"4093",492,90,402,191.918062172325,176.106590522272
"4094",503,90,413,176.753070120154,178.557722166353
"4095",488,81,407,194.629493239197,173.548005437825
"4096",495,84,411,203.012690871024,178.681790657103
"4097",492,83,409,191.477945297945,179.513749575589
"4098",489,89,400,197.08885378221,174.862479393814
"4099",477,80,397,203.626733717022,176.829891384898
"4100",482,80,402,201.3059880399,178.096312600433
"4101",507,90,417,200.293805786889,179.473994355087
"4102",507,95,412,193.079796178416,180.587498276768
"4103",495,92,403,201.09944806095,184.817961114872
"4104",489,91,398,192.440942527486,178.695524673817
"4105",494,82,412,190.931363829246,184.970999341636
"4106",469,83,386,198.764485745896,174.776043348632
"4107",484,92,392,189.910652149842,167.109642294947
"4108",495,91,404,210.038936526734,172.496511605141
"4109",485,85,400,201.383549507674,178.477663844061
"4110",497,86,411,195.874098683373,172.764832730804
"4111",492,83,409,199.521720144911,176.813219059147
"4112",483,83,400,205.144778701284,182.647085656786
"4113",473,78,395,196.636693524519,176.348029004629
"4114",477,84,393,213.12258838061,176.382160227736
"4115",492,84,408,194.106137570984,181.729082859505
"4116",478,84,394,197.334653775442,180.439469666494
"4117",479,85,394,185.557691176913,174.1887226537
"4118",487,81,406,202.695890274904,174.421795316993
"4119",483,92,391,186.903003955223,174.437065044452
"4120",508,83,425,202.419610110784,178.612475799953
"4121",498,88,410,202.530051597932,175.65124501234
"4122",484,87,397,206.587638797906,183.769850333933
"4123",481,89,392,187.2040466611,176.213867936042
"4124",478,77,401,184.21995482149,175.476398176809
"4125",492,91,401,194.369402481851,178.273766771882
"4126",501,91,410,190.349089903169,182.897752863266
"4127",484,93,391,185.885816439439,173.834816520677
"4128",481,83,398,200.937369891746,173.068019204072
"4129",477,76,401,188.239319228386,176.397733253573
"4130",501,93,408,200.153920053637,178.558934477101
"4131",472,85,387,198.447182260207,182.505804249143
"4132",484,81,403,207.883109292397,174.891596720976
"4133",481,86,395,193.720760388204,174.605386622139
"4134",487,90,397,195.784803736826,171.020718689036
"4135",495,86,409,196.361882945857,175.549295398006
"4136",474,84,390,188.50393833779,178.844373836184
"4137",486,81,405,192.803200201944,176.874207373634
"4138",486,89,397,188.000773315782,174.141213315954
"4139",500,84,416,204.531218717628,183.250583973304
"4140",480,83,397,191.309778012708,175.395837869898
"4141",490,83,407,187.443902785706,181.89148230135
"4142",506,86,420,195.143377315657,176.230850262557
"4143",496,87,409,208.136967232836,177.588582538896
"4144",475,82,393,197.517361792932,178.926968856449
"4145",483,87,396,197.199170552288,183.914792600105
"4146",471,82,389,187.560238386381,167.219500530442
"4147",481,82,399,203.339524347319,171.510155007378
"4148",481,86,395,189.941035571125,180.417029279353
"4149",476,87,389,198.623636647816,180.215649001696
"4150",475,87,388,195.322957953261,175.052057405288
"4151",471,81,390,193.817563536331,177.640830585494
"4152",476,84,392,198.659216406914,178.518990978018
"4153",472,88,384,191.754566882726,176.948954818602
"4154",474,85,389,182.743520727666,185.956123809284
"4155",498,90,408,210.636501107323,181.248298349572
"4156",490,97,393,184.995387530844,175.099381648266
"4157",483,85,398,195.226372866581,178.182877541947
"4158",481,89,392,206.877835589312,178.348536827276
"4159",471,85,386,185.045041316111,181.795000757357
"4160",488,85,403,192.554569152707,180.196630793574
"4161",495,91,404,202.549014283031,178.147943263401
"4162",482,90,392,193.315267487847,176.422075782808
"4163",473,77,396,198.787728419031,178.636701361512
"4164",492,87,405,189.642802466006,173.320665844884
"4165",481,91,390,203.385572918621,171.928202527634
"4166",469,89,380,186.045877159611,182.071407002761
"4167",486,92,394,185.439435208043,175.487316603719
"4168",497,90,407,192.458477142659,175.815513127364
"4169",502,96,406,197.019621816205,171.088735874928
"4170",484,84,400,193.711310183922,172.78486869041
"4171",491,79,412,202.025521247265,177.297184732254
"4172",486,89,397,200.335036472365,168.627080733353
"4173",502,92,410,198.191338611703,176.501514878335
"4174",479,83,396,193.023875092229,183.92913664975
"4175",479,89,390,187.17808985481,179.430249285269
"4176",484,83,401,189.906015698748,178.353111443755
"4177",485,88,397,210.78070697793,181.42851874719
"4178",478,88,390,193.916310281232,183.834128979476
"4179",480,80,400,195.910914735051,172.442411166804
"4180",492,88,404,206.878396686124,179.170340400747
"4181",497,87,410,205.250923657602,180.109156329443
"4182",475,91,384,191.629889411041,177.439375439611
"4183",483,88,395,198.224779405782,172.451744488483
"4184",482,91,391,187.838105076023,170.816257260513
"4185",490,84,406,205.792836365073,180.556798308668
"4186",502,94,408,189.085690869742,178.135553389829
"4187",481,86,395,196.674952894862,179.796109935278
"4188",484,88,396,189.232117454857,173.991074951143
"4189",484,82,402,196.693116049048,171.54263593611
"4190",495,89,406,205.513948770154,172.871288061988
"4191",479,84,395,199.456379304113,176.055942970926
"4192",479,83,396,210.256791971371,179.343571566658
"4193",485,94,391,195.411440469737,176.512307725946
"4194",490,82,408,204.814123136061,175.170532326277
"4195",491,78,413,186.830844791635,180.994373666579
"4196",501,96,405,190.857570827719,177.55389516098
"4197",499,84,415,193.5625019854,177.347124947748
"4198",490,81,409,205.834868310017,175.24936675608
"4199",492,86,406,194.257142273821,173.302913954661
"4200",482,82,400,206.379752933392,177.222026941969
"4201",476,85,391,200.281983508541,171.209156792732
"4202",495,91,404,194.491159842317,176.539737095393
"4203",482,81,401,192.837808044362,176.835982936001
"4204",467,79,388,192.968058627527,175.55261555484
"4205",498,88,410,194.556435296461,170.994526678012
"4206",487,89,398,204.910463374362,171.993404343124
"4207",498,80,418,192.714026683488,179.889773484675
"4208",487,87,400,201.339156857488,175.179420924319
"4209",491,100,391,194.216512747521,174.376485915188
"4210",492,86,406,184.743614545275,175.900977193211
"4211",490,82,408,197.91657004539,175.333999381103
"4212",481,86,395,204.674002759863,176.011424909283
"4213",480,84,396,199.67369817548,182.205721566872
"4214",490,83,407,202.829679185412,173.990651392621
"4215",482,86,396,191.113440340005,174.228150988915
"4216",470,81,389,211.861369386353,175.91719312595
"4217",479,80,399,206.015922408076,178.845775617626
"4218",494,87,407,189.426152227611,178.994447588186
"4219",467,75,392,205.88868324598,179.832761557577
"4220",495,90,405,196.957328106198,171.06129503846
"4221",475,83,392,194.857608145785,181.129654788957
"4222",473,75,398,198.325456254956,175.323206995606
"4223",486,86,400,197.78378740096,177.454825615661
"4224",480,84,396,193.079805822954,178.321919676196
"4225",495,92,403,207.583327231854,175.493115308337
"4226",467,83,384,213.565015456817,177.782617132132
"4227",464,81,383,196.68192807928,176.166367532051
"4228",487,91,396,195.910677554954,177.481934926168
"4229",495,92,403,195.202625573858,171.577913219591
"4230",481,87,394,184.955682257348,176.30487387562
"4231",499,89,410,191.739257973942,179.033727051994
"4232",483,95,388,202.276244668834,179.84199364701
"4233",477,88,389,206.028874492031,176.422337917981
"4234",461,83,378,196.603905241046,177.782192631104
"4235",492,89,403,195.95083297896,180.313328743894
"4236",474,87,387,181.327214718421,183.457394481569
"4237",487,83,404,194.377754345147,174.776204497163
"4238",481,87,394,188.622949319726,176.278133333552
"4239",477,81,396,188.352776057043,183.729202860971
"4240",488,85,403,202.846321395204,175.645650859131
"4241",492,85,407,197.792089506995,176.291094589188
"4242",482,88,394,184.034528974499,171.592208555839
"4243",484,80,404,206.866027631435,181.228440975366
"4244",480,89,391,193.213527751547,175.54868876975
"4245",458,71,387,197.189695748747,173.772900497745
"4246",489,85,404,183.974627671955,175.104853162049
"4247",486,87,399,202.761967584207,177.266657013037
"4248",473,84,389,195.2137438857,178.623479343698
"4249",482,84,398,196.265115244331,182.662952258103
"4250",500,92,408,205.650152582858,179.049038655046
"4251",492,97,395,189.359007665699,179.358112724826
"4252",501,89,412,191.165247096413,175.597638282828
"4253",489,87,402,180.274950067907,175.111296963982
"4254",489,84,405,188.484627006472,174.868163319868
"4255",492,84,408,196.857119093007,177.240473784069
"4256",488,81,407,196.548898911811,167.750272028133
"4257",491,80,411,197.605512443415,180.901033868248
"4258",488,88,400,187.00802094737,179.439775022027
"4259",481,94,387,219.611680082971,173.38048222363
"4260",482,89,393,201.23290370093,175.274500902017
"4261",480,89,391,200.289682119202,178.484699879431
"4262",495,87,408,202.416323011548,178.454539143983
"4263",503,89,414,183.334448249164,180.241368860586
"4264",499,85,414,184.455456477635,175.018952824446
"4265",491,83,408,209.931638024275,173.883011008884
"4266",479,78,401,184.256663219968,183.898149839279
"4267",488,83,405,183.502612863394,170.431353816856
"4268",475,89,386,200.226705334634,175.742702055834
"4269",491,97,394,189.619516363934,180.741985438635
"4270",483,88,395,190.005225793283,180.501723745952
"4271",484,91,393,207.085677667739,176.580151730489
"4272",483,87,396,184.871137995216,183.974723249248
"4273",482,85,397,182.617151282475,175.092712658771
"4274",491,92,399,200.958586107044,178.113966677994
"4275",499,96,403,186.871256166782,182.431820229995
"4276",479,92,387,208.804807546563,180.799889206047
"4277",475,83,392,204.630657219726,177.861047153047
"4278",462,81,381,203.438778306411,175.059384484028
"4279",484,82,402,201.875000214408,174.490043107657
"4280",478,87,391,208.364349834892,176.265028432377
"4281",470,90,380,195.039773032909,178.908783988198
"4282",480,84,396,183.817872912729,182.512878357976
"4283",502,93,409,195.496585290696,176.080925526572
"4284",482,82,400,195.311569515965,176.763052522127
"4285",494,90,404,180.671092707895,175.770021486042
"4286",470,85,385,191.685088182232,172.14028993668
"4287",492,92,400,199.185607356494,176.719140540812
"4288",474,79,395,192.595681654096,170.043671132372
"4289",480,83,397,202.871703104495,177.27688392769
"4290",485,89,396,193.473921201382,172.791859741074
"4291",491,83,408,195.204879187519,168.489305690068
"4292",482,78,404,186.029251150843,179.086421227182
"4293",481,84,397,193.272411035549,170.007559346754
"4294",477,83,394,198.876734419154,172.727599205552
"4295",474,83,391,195.067683319394,175.59358515291
"4296",490,82,408,196.843945660399,176.588313859326
"4297",480,79,401,179.002797465184,173.513562981992
"4298",480,90,390,181.195871001871,177.028613614528
"4299",484,83,401,200.389059023298,176.347036987652
"4300",464,76,388,189.119858356359,176.438847630675
"4301",479,87,392,195.242903276874,172.182150663134
"4302",495,98,397,199.582709216477,180.198265782188
"4303",500,89,411,196.590427119951,176.865118187999
"4304",489,84,405,194.884585205272,174.750856629645
"4305",494,93,401,193.283644066078,175.992325368638
"4306",478,82,396,191.989829230586,175.702797093316
"4307",476,77,399,193.3915590717,173.036700722924
"4308",482,88,394,186.779794477447,173.097512630198
"4309",491,86,405,203.676840185184,174.223007049175
"4310",482,91,391,184.131457269787,177.79831987235
"4311",483,80,403,188.891820812815,178.547793068477
"4312",481,80,401,201.438174735481,171.744536539173
"4313",477,84,393,186.29727509496,176.745714327349
"4314",483,87,396,199.625658309047,175.005425894326
"4315",498,82,416,198.63623709714,182.02500075992
"4316",474,78,396,193.311079048311,184.795000699445
"4317",479,94,385,200.116191651331,177.334203601316
"4318",485,83,402,196.36618868945,179.09753143098
"4319",480,82,398,198.65531205813,176.38707142259
"4320",489,91,398,192.546545061826,173.035366756267
"4321",481,88,393,189.187407645188,173.932977394757
"4322",477,90,387,189.662751268499,179.955964356706
"4323",473,77,396,194.939160923413,179.842069577701
"4324",489,87,402,189.879163344266,173.891615905461
"4325",491,86,405,187.312947678422,177.193998728486
"4326",485,88,397,189.738759368012,176.171967817534
"4327",483,79,404,203.663961794139,174.691945832626
"4328",486,96,390,189.494075398809,167.416199936342
"4329",477,87,390,191.41930340405,179.565120795119
"4330",492,88,404,188.7384998735,177.186834791442
"4331",488,77,411,192.933518819843,181.907898006912
"4332",491,90,401,191.856531348012,181.022412075546
"4333",467,86,381,200.453410441777,182.187134964
"4334",487,77,410,186.797932424309,183.287753314703
"4335",480,85,395,200.646482652379,173.177925959871
"4336",476,83,393,178.71116166542,180.792222638188
"4337",484,85,399,184.897980629255,175.563060582478
"4338",471,86,385,177.01511226252,176.562314805378
"4339",468,86,382,204.500434090477,174.887346229301
"4340",482,87,395,195.236608775204,170.746491134763
"4341",480,85,395,195.968313737617,176.535637307464
"4342",497,87,410,187.86100273965,173.744795419731
"4343",492,91,401,192.176539665238,176.540384163596
"4344",480,94,386,172.049112406601,177.298966072604
"4345",494,85,409,206.385728984588,171.834336413895
"4346",467,77,390,202.289522754116,183.009388544926
"4347",499,84,415,205.075849193893,173.262044481698
"4348",473,81,392,186.914432662301,180.965341281006
"4349",481,84,397,170.197864859261,177.450276054089
"4350",489,93,396,200.170654841867,176.501658606135
"4351",481,89,392,209.253668493796,178.786858351728
"4352",489,82,407,187.53853037884,179.707000097618
"4353",486,81,405,199.264826251598,172.885228423051
"4354",473,91,382,191.5587803387,176.986613543019
"4355",471,87,384,187.423891217726,174.948971933861
"4356",494,90,404,203.956681002896,179.083456186757
"4357",483,88,395,198.804392658295,176.227584754323
"4358",498,94,404,192.782219415966,176.197536552255
"4359",478,92,386,181.060084880871,175.90863669653
"4360",488,86,402,189.525595470038,179.061769378849
"4361",480,91,389,195.34509185971,175.776507880737
"4362",475,83,392,196.021883572339,179.329326698854
"4363",483,88,395,197.596290196453,177.908309302655
"4364",468,83,385,203.968625607765,178.116874844053
"4365",490,85,405,200.017720458514,175.761160032082
"4366",479,85,394,181.780958732381,182.589790434073
"4367",494,93,401,191.635418990799,176.871413757441
"4368",476,88,388,186.389328302125,173.549967299745
"4369",494,82,412,189.638781124884,183.371422969343
"4370",502,86,416,206.785289568542,179.924912295055
"4371",492,88,404,208.199493561073,174.344731737673
"4372",492,97,395,207.590911141365,174.01698217531
"4373",497,80,417,188.959848568068,173.862731026561
"4374",476,89,387,193.982283866314,179.162666170399
"4375",486,87,399,207.698008756393,176.944078430957
"4376",481,80,401,204.911255500948,178.68357500442
"4377",496,92,404,200.600686564135,175.865752293934
"4378",496,92,404,204.138241452851,172.687964050725
"4379",485,85,400,200.450613459139,176.746615137223
"4380",480,88,392,198.240454700755,179.141269171236
"4381",472,79,393,195.515370203404,179.496470951082
"4382",495,87,408,197.931671652713,173.648285528595
"4383",490,99,391,203.922515063504,178.084525022606
"4384",484,88,396,195.650588532384,181.766158776706
"4385",496,85,411,193.198463711893,172.715775330352
"4386",478,81,397,196.152104567304,176.628419196027
"4387",477,79,398,208.987380831597,179.605596446744
"4388",499,92,407,195.981743473525,179.665203093717
"4389",492,90,402,186.449749939663,178.742157903572
"4390",485,85,400,190.457904431388,181.824344453757
"4391",495,83,412,202.458427544361,179.316142636506
"4392",485,83,402,183.680154022571,175.514042758228
"4393",479,79,400,181.062488801047,178.084427317924
"4394",488,84,404,198.017701193387,181.014566575741
"4395",495,90,405,177.228968399191,177.187048211964
"4396",486,94,392,196.186519262829,174.034614833247
"4397",482,90,392,189.400173971591,171.815040477271
"4398",486,90,396,185.524850581965,177.8525186344
"4399",497,91,406,202.715028745361,178.254184221349
"4400",500,91,409,193.020055323529,176.297671187033
"4401",488,83,405,183.283736547182,180.148357327223
"4402",485,84,401,202.611518965627,177.227271201108
"4403",477,84,393,178.467884172065,174.522802421427
"4404",503,85,418,204.22374758728,178.871327694315
"4405",488,95,393,189.1164091313,178.362330781153
"4406",488,88,400,201.306300344453,175.727979892
"4407",487,81,406,192.354572618091,172.140222234127
"4408",497,97,400,190.101919873215,172.070602246838
"4409",459,81,378,192.740252176158,173.058967360251
"4410",481,76,405,199.126945269469,176.055238350816
"4411",475,87,388,183.041412704757,170.78892193913
"4412",478,84,394,176.294003299159,169.906012390573
"4413",500,82,418,191.417825003388,177.516235695915
"4414",489,86,403,206.884290312029,177.819480377413
"4415",496,84,412,209.856852024605,177.639903696132
"4416",493,81,412,182.702868066266,177.851164214463
"4417",495,84,411,202.123228116339,180.035855722577
"4418",482,84,398,201.612222702292,176.175028406144
"4419",471,79,392,200.097237735521,181.355930889875
"4420",482,83,399,198.797506650364,176.759220161483
"4421",486,86,400,186.341945009061,181.17111679474
"4422",497,84,413,196.305807300069,178.451425847272
"4423",467,83,384,195.729266485098,179.373560622293
"4424",484,94,390,205.223879301604,175.200588909556
"4425",494,80,414,203.533312629969,172.628829967528
"4426",478,84,394,205.737176916202,172.571916473795
"4427",491,84,407,204.216150476296,175.235927520177
"4428",491,85,406,198.843311829029,170.734126378136
"4429",493,84,409,183.86396356394,178.105555067567
"4430",488,78,410,208.477011820702,178.253833958591
"4431",473,91,382,190.533633581906,179.09235653796
"4432",497,96,401,190.131867557072,179.961269835019
"4433",506,101,405,174.387398875917,180.409913674532
"4434",486,90,396,185.402105568813,175.638310076954
"4435",493,87,406,188.367940419677,180.184447779799
"4436",507,94,413,192.202142683879,176.923684964498
"4437",473,84,389,194.998535935698,175.086524288555
"4438",485,89,396,205.147195525427,174.635809629776
"4439",499,88,411,182.716221798675,179.238220404253
"4440",486,82,404,184.36799671655,177.198349390392
"4441",465,78,387,210.587127872823,176.954916702576
"4442",477,86,391,196.712688327308,170.039322916515
"4443",484,79,405,200.523883459788,179.777416935531
"4444",476,80,396,206.935407309412,185.659181582453
"4445",494,87,407,182.720684967448,180.396530137743
"4446",483,89,394,178.041867271438,176.450464291217
"4447",495,85,410,203.164141222736,176.661543867717
"4448",484,83,401,185.542646672754,172.518264096185
"4449",483,86,397,199.486874885098,179.346283166849
"4450",478,87,391,200.391487417409,181.231449973842
"4451",481,96,385,192.82094811052,181.781268553626
"4452",477,88,389,199.468435571464,180.464037307777
"4453",496,84,412,177.713559805002,175.878361143459
"4454",493,89,404,192.024123716532,179.7141060723
"4455",488,80,408,205.501744286266,171.808098717483
"4456",496,94,402,195.838425950528,180.910792998847
"4457",470,96,374,195.045864630963,164.67234576135
"4458",492,92,400,196.434530634171,170.247832957253
"4459",489,90,399,192.274079122182,183.242502998812
"4460",469,82,387,196.458140431126,172.399934402539
"4461",497,85,412,183.915413234626,178.62112450952
"4462",466,83,383,194.077377144799,174.273398758101
"4463",486,84,402,191.05762104206,177.008730823228
"4464",487,85,402,195.406907949725,182.80246410431
"4465",478,87,391,185.778489855663,179.147917472868
"4466",482,94,388,200.105162361734,171.424063803675
"4467",489,78,411,198.813367439231,180.09555848206
"4468",496,90,406,202.248660078742,179.778188946762
"4469",480,85,395,197.565516763885,176.27968713979
"4470",488,87,401,195.546591410306,176.970018116329
"4471",481,86,395,203.142906269615,179.391808556977
"4472",483,84,399,190.92124290288,179.583218907082
"4473",480,93,387,187.339533829504,178.092687727301
"4474",489,86,403,186.997474377294,179.872721653702
"4475",472,83,389,200.738364344892,179.847762903494
"4476",485,85,400,199.699931019838,182.570131230433
"4477",490,85,405,197.966158491639,180.719497566622
"4478",487,80,407,195.42823528828,178.380963877509
"4479",492,88,404,203.996062550678,176.364440973051
"4480",477,96,381,197.585619729821,174.365247128457
"4481",479,85,394,194.213974412398,175.432621152756
"4482",490,85,405,193.632251774527,174.740285768214
"4483",504,95,409,209.232590749371,175.159674773209
"4484",502,87,415,179.891917637934,178.302929895077
"4485",492,83,409,202.904742972303,179.929562868586
"4486",472,81,391,189.321394721139,171.858529035103
"4487",474,85,389,209.148292926496,172.224723360573
"4488",480,76,404,200.535745217597,177.485134750535
"4489",476,83,393,184.587435632336,181.056827644559
"4490",480,90,390,189.862237385106,179.154434823967
"4491",512,85,427,195.507494804877,172.241932171861
"4492",472,80,392,192.063265382658,173.90214265659
"4493",480,79,401,199.09672383796,174.643475625945
"4494",478,84,394,190.526599159097,179.573531693515
"4495",481,90,391,195.188738679916,180.088658856087
"4496",471,78,393,204.186905675278,174.948709087779
"4497",494,85,409,212.243832966042,175.416910726872
"4498",494,89,405,180.827469402723,185.886562083137
"4499",492,89,403,182.025657311719,177.914781303653
"4500",487,79,408,197.757042170833,173.667078959502
"4501",481,80,401,209.633683288294,172.515697012704
"4502",510,96,414,182.834216981606,177.934606887301
"4503",495,87,408,201.325105598748,169.842427684775
"4504",476,86,390,205.82338331338,177.65497183746
"4505",485,86,399,186.2981630326,181.891724821464
"4506",487,89,398,200.847271077121,176.105841713221
"4507",482,81,401,190.24490703434,179.057062359133
"4508",483,81,402,185.577696114177,178.477194680299
"4509",484,84,400,193.022959249597,175.588090294181
"4510",500,91,409,199.585680244139,171.632950111356
"4511",484,84,400,209.177057126353,178.017539516948
"4512",482,94,388,194.151706336972,177.033469644246
"4513",487,85,402,192.137903803147,177.26288141646
"4514",487,89,398,211.841520034059,170.78060651454
"4515",483,85,398,201.690568111883,181.028221023605
"4516",484,87,397,189.983133064326,170.260742419023
"4517",473,85,388,215.308434681491,179.896628013073
"4518",474,87,387,206.322337577954,176.198576936533
"4519",484,87,397,190.084463171574,175.940406245904
"4520",481,80,401,199.660163877287,176.449720732833
"4521",482,82,400,203.794797294641,179.376433315298
"4522",467,90,377,203.77153704989,177.657131974288
"4523",495,83,412,199.795819150639,174.229805992933
"4524",484,87,397,183.866039769631,180.536785614694
"4525",481,81,400,190.411714985739,176.923568337075
"4526",496,87,409,196.148340328862,175.752936772995
"4527",486,91,395,198.350263894245,181.942325340424
"4528",469,86,383,181.297691911994,167.949512295186
"4529",486,89,397,190.785104188934,180.29464320547
"4530",504,88,416,199.578212357271,176.27556363829
"4531",470,92,378,191.756946337426,172.234247850354
"4532",472,85,387,181.100259904832,180.216741788931
"4533",496,83,413,181.821868533623,173.092157990006
"4534",466,84,382,204.333508592051,176.082500937344
"4535",485,84,401,199.766707980477,175.025153959205
"4536",491,87,404,194.74743201137,179.341369889237
"4537",478,84,394,196.986505751943,177.032012999695
"4538",488,80,408,207.431602962014,180.157710238488
"4539",477,91,386,192.355867588878,179.97082365652
"4540",484,89,395,189.576896735938,178.889732740002
"4541",481,86,395,187.925321219982,178.968229378924
"4542",472,75,397,201.964280900913,173.48260164754
"4543",501,95,406,202.012675668503,175.071018110165
"4544",482,84,398,186.57873824071,172.578772441605
"4545",500,82,418,196.56583503528,182.768199738801
"4546",496,92,404,189.632308107243,174.457101256395
"4547",466,83,383,196.858065030124,174.968117763172
"4548",485,83,402,188.40456611348,183.65024112877
"4549",483,83,400,196.743535216065,172.361555117183
"4550",473,84,389,208.509243811063,182.063574190739
"4551",492,85,407,188.858063446168,176.716156516487
"4552",495,88,407,200.11509693848,177.50726582931
"4553",487,88,399,192.86897510401,181.36432459029
"4554",493,85,408,208.700548462547,174.37252328025
"4555",493,88,405,194.968017033345,176.223620229581
"4556",503,96,407,193.401707611753,178.736179399616
"4557",482,81,401,191.227083255526,179.952463060277
"4558",487,90,397,194.469897948688,177.600138167903
"4559",478,83,395,199.437408120151,177.787153852247
"4560",475,93,382,176.245240613947,168.273402933808
"4561",500,84,416,189.244407584438,178.923896272787
"4562",494,93,401,198.775518234155,175.910386046792
"4563",485,85,400,202.289236000166,181.089300443307
"4564",482,89,393,187.2472615563,179.048552900073
"4565",465,78,387,189.993695281778,178.205433579348
"4566",488,89,399,192.152244099666,172.085287432492
"4567",489,93,396,199.626519132533,174.844713969465
"4568",481,85,396,195.697236673958,173.678925943361
"4569",493,82,411,205.858155421791,175.37488321737
"4570",487,85,402,195.127750888196,180.481512386022
"4571",491,82,409,199.081617716167,174.467100258213
"4572",502,85,417,199.184946410312,175.96928669636
"4573",493,87,406,181.303717672583,180.145644175102
"4574",476,79,397,203.582112781081,181.414380102035
"4575",475,89,386,182.5084390132,172.640154672211
"4576",495,89,406,198.412844899178,176.696073352107
"4577",503,91,412,210.912762872913,182.026204617885
"4578",483,89,394,199.936721518786,176.654775865749
"4579",492,82,410,205.310139423931,172.527769781367
"4580",465,75,390,194.173994648813,178.050634389776
"4581",476,81,395,205.109103928511,181.1329737161
"4582",492,78,414,191.600972262522,180.043358346335
"4583",479,85,394,200.558497113179,178.969462632765
"4584",489,86,403,204.029129168359,175.206344093417
"4585",491,86,405,191.215407559602,171.114424503827
"4586",476,85,391,182.629994869471,177.258646333064
"4587",480,89,391,189.487639005468,177.8778808381
"4588",468,89,379,190.197038392497,171.213241725546
"4589",483,84,399,202.088858540018,175.420022450191
"4590",489,93,396,198.659624523555,182.7011403268
"4591",483,78,405,199.322625967127,180.259400430554
"4592",484,93,391,194.08573300244,180.970328649109
"4593",478,83,395,209.853193129045,172.500833525546
"4594",472,79,393,201.594699517785,181.938141315152
"4595",474,89,385,187.567845787579,171.389878483532
"4596",477,77,400,198.170049770952,178.998440934637
"4597",497,86,411,195.755743116092,181.507266262559
"4598",471,83,388,201.527336501839,176.486819248158
"4599",480,84,396,194.211104761861,173.774558593594
"4600",496,95,401,200.080410646863,169.233620077167
"4601",495,82,413,191.634114178491,172.475057744008
"4602",472,85,387,190.546928670471,174.35844791497
"4603",476,89,387,202.666773287018,181.375390080171
"4604",476,89,387,188.82255933054,172.858450344932
"4605",467,81,386,199.320823067871,175.306750567784
"4606",481,91,390,191.322173599465,174.330115305702
"4607",476,86,390,204.859017395719,178.814575563649
"4608",473,86,387,195.74088324947,176.742537648127
"4609",486,90,396,192.283313398492,183.16482270307
"4610",473,88,385,192.370405737375,173.147213968837
"4611",475,83,392,195.183708850834,184.657900396699
"4612",477,86,391,208.170752275509,174.472502733065
"4613",477,85,392,189.776985252093,179.831697298372
"4614",490,85,405,189.440677937198,179.299834692149
"4615",500,91,409,196.959206834167,179.397171406241
"4616",486,89,397,191.443703531835,181.010137388652
"4617",480,88,392,192.863935788623,171.325857872318
"4618",477,84,393,196.822956728224,177.16543501542
"4619",492,81,411,193.430453900815,174.624660370591
"4620",466,81,385,179.510638842151,178.417116488442
"4621",478,87,391,186.679369643904,183.024054361424
"4622",473,78,395,194.055957951331,179.965622022497
"4623",495,87,408,189.240938997912,175.757524915837
"4624",477,85,392,187.711294942373,174.7038367427
"4625",484,87,397,191.932384360665,178.508503906689
"4626",499,93,406,179.429783220792,177.506043889927
"4627",492,86,406,180.420163831249,173.778426942904
"4628",476,87,389,204.694650727938,174.123135189314
"4629",473,89,384,191.932931276484,176.884255843661
"4630",483,90,393,191.868973696028,177.646511549391
"4631",482,78,404,200.958736310094,177.230675495758
"4632",487,92,395,204.52190185363,183.627411501637
"4633",493,94,399,195.355667929832,175.283783726622
"4634",499,89,410,190.637087057807,174.876173008546
"4635",479,85,394,185.740864472899,181.084921121701
"4636",495,90,405,186.069948634377,182.922221830162
"4637",470,85,385,195.866680236399,178.162912248444
"4638",496,79,417,195.690101462713,177.537504505318
"4639",484,87,397,176.71079257923,172.748607246222
"4640",476,79,397,212.245345574722,170.533163363503
"4641",501,88,413,210.506037311306,176.026089653424
"4642",485,85,400,197.821949465619,180.235426951841
"4643",480,90,390,196.662609680794,179.002682709748
"4644",480,81,399,201.77464048378,171.786668640663
"4645",479,87,392,180.426831488685,176.641115620428
"4646",486,93,393,193.433228245188,172.813619929979
"4647",477,93,384,188.718243473047,177.163498476954
"4648",469,87,382,189.752854596137,174.338996366927
"4649",502,87,415,203.494651239715,175.943094266655
"4650",483,78,405,196.644486471175,178.052974607983
"4651",475,80,395,192.738670406114,174.175860736888
"4652",479,80,399,201.894915414423,178.706958726888
"4653",470,82,388,185.553300847504,181.098332889485
"4654",490,85,405,192.714349089743,177.995709205773
"4655",500,95,405,183.100651824479,174.890707512598
"4656",474,84,390,193.199190858125,180.099643438743
"4657",488,96,392,187.815657174752,182.898803125799
"4658",491,84,407,189.744453403185,174.394109906144
"4659",487,79,408,203.714796675933,177.542906024994
"4660",473,90,383,201.542353520132,177.615230776784
"4661",469,86,383,201.143723822049,178.568976061312
"4662",463,84,379,192.2832552153,170.967605555793
"4663",491,83,408,200.857283619537,175.989638679632
"4664",474,78,396,202.703880014694,176.882494450604
"4665",470,87,383,198.924994927298,175.505116435822
"4666",490,92,398,199.96219277256,182.085049820994
"4667",483,84,399,191.466723993347,183.314146707316
"4668",470,86,384,195.665586952926,180.048103840167
"4669",498,85,413,194.315582919776,176.019453016242
"4670",487,93,394,191.995601367638,181.266694217629
"4671",487,92,395,190.087943136021,174.530631416497
"4672",472,83,389,205.006344915401,179.927146795272
"4673",491,86,405,203.410999591855,170.092975584438
"4674",491,91,400,189.118134896698,176.789403094748
"4675",488,83,405,192.68038084247,173.998877056164
"4676",480,89,391,206.181109308538,169.898786041519
"4677",494,86,408,200.675357451311,179.674461276334
"4678",470,74,396,187.591863964463,174.203633332232
"4679",487,92,395,202.010732083452,173.387897078348
"4680",488,85,403,210.859040535989,176.967298674805
"4681",486,87,399,198.561291446554,180.267555313342
"4682",488,87,401,198.063568462864,182.294859161172
"4683",492,86,406,190.931290586174,173.648810338575
"4684",486,82,404,196.087443806472,177.117633509879
"4685",486,81,405,198.150830809096,176.599007150209
"4686",484,84,400,190.327684386273,184.076547136835
"4687",463,85,378,193.776254598523,172.964729693822
"4688",473,82,391,194.748408286556,177.90137835145
"4689",491,81,410,184.791827929314,179.496357162817
"4690",476,85,391,194.374305857536,175.113590287286
"4691",490,87,403,195.534347120697,173.2312592364
"4692",486,88,398,187.401754317524,180.936248619973
"4693",499,82,417,195.80780072582,180.633842635754
"4694",480,81,399,193.381392504237,176.802860717977
"4695",495,88,407,193.667440930344,175.602649931576
"4696",491,88,403,188.628437183211,179.828107041879
"4697",498,90,408,180.03569999922,176.582513183055
"4698",493,79,414,197.556983872664,180.955117982658
"4699",480,93,387,188.702208664568,177.943024824283
"4700",494,98,396,189.602451251097,177.429791840231
"4701",491,91,400,194.275564839029,176.159687940822
"4702",489,85,404,191.339382600317,174.397016459678
"4703",482,79,403,192.244193436095,184.21054542255
"4704",485,83,402,194.971871158202,183.304789968203
"4705",483,85,398,210.466346865545,177.632250042339
"4706",489,90,399,173.849349398756,175.611062303088
"4707",479,83,396,190.251140100972,173.350710710036
"4708",489,80,409,189.367528853368,177.670097678801
"4709",485,90,395,196.520665208144,181.291995853565
"4710",496,88,408,190.662285800765,180.785578937088
"4711",478,84,394,189.909160385702,168.464960495152
"4712",490,86,404,194.273580099791,175.497084031905
"4713",503,88,415,204.123577004222,171.402765200065
"4714",494,95,399,185.905545006011,176.645883724381
"4715",501,91,410,202.079567203941,176.629846210334
"4716",477,85,392,183.983962553478,180.215698486099
"4717",485,86,399,201.148870150465,174.01411027308
"4718",471,85,386,185.451453122722,169.978557826865
"4719",491,94,397,190.791442396503,183.535200050291
"4720",490,87,403,199.238077352991,179.169954405099
"4721",485,92,393,189.216563807693,181.304040198895
"4722",487,90,397,209.037784734272,178.507603173225
"4723",482,88,394,198.940508316868,174.263108877259
"4724",467,77,390,197.712505160415,171.424994409279
"4725",476,82,394,198.017150001632,172.599247089031
"4726",506,92,414,189.916379094051,177.586033285367
"4727",492,85,407,204.413774727511,176.60326485802
"4728",499,86,413,189.356421247819,181.000474422381
"4729",483,86,397,190.597211707821,181.104645117175
"4730",480,91,389,194.077754721932,175.216725015245
"4731",470,80,390,190.827090570383,174.190436088564
"4732",473,92,381,197.506956750883,179.602972207743
"4733",475,83,392,184.546907213076,176.58619212985
"4734",480,86,394,185.436414681068,174.559036501749
"4735",478,83,395,209.452693756461,182.460505117965
"4736",489,80,409,193.155992782932,178.237383132676
"4737",478,83,395,189.85707499234,170.783129476438
"4738",500,89,411,198.376818872973,176.932353108251
"4739",488,90,398,189.039180663895,175.7026763297
"4740",482,86,396,205.180289306276,177.991191839692
"4741",485,82,403,196.359547514478,176.761312042176
"4742",477,85,392,187.387182492985,177.487360832602
"4743",483,79,404,192.065003980123,179.987572168224
"4744",501,94,407,202.364121906553,184.914370410936
"4745",485,81,404,194.69402605978,183.872798329301
"4746",487,91,396,195.701899513236,178.043507759535
"4747",488,90,398,206.669133210639,174.879361587799
"4748",482,91,391,183.617519898573,181.552946452375
"4749",486,88,398,187.01168605734,172.782000783155
"4750",500,90,410,200.424016555403,172.229132880718
"4751",493,85,408,197.761515404313,175.107109382236
"4752",473,89,384,184.813811075307,171.323161328756
"4753",495,88,407,199.006337010846,173.523162846301
"4754",489,80,409,183.366668954615,179.8367637359
"4755",492,85,407,183.445050462138,174.481054819304
"4756",496,89,407,181.867911978167,177.886041841203
"4757",462,79,383,180.140336181256,178.03083118693
"4758",482,84,398,198.812582847911,171.606369382774
"4759",482,86,396,188.263193094562,175.021198478016
"4760",480,85,395,203.984753717776,174.783592551786
"4761",482,81,401,188.251185167893,177.345029708717
"4762",493,83,410,205.189119879341,181.891420935675
"4763",487,92,395,207.101085668215,180.053351109779
"4764",482,90,392,195.780803118937,169.944254683616
"4765",482,88,394,203.331155252619,168.561762585275
"4766",478,83,395,202.138156215545,173.452736786565
"4767",465,74,391,188.795153934721,173.34205800832
"4768",473,86,387,190.495781489525,175.161294403071
"4769",497,88,409,181.581273018214,181.166588692943
"4770",474,84,390,201.670072501917,177.24100105207
"4771",481,84,397,201.849575965908,179.337111746022
"4772",470,75,395,186.79959510994,172.952992148978
"4773",488,89,399,206.237198721743,182.471071918311
"4774",495,95,400,196.069743735411,168.546383585229
"4775",479,82,397,191.460646967048,174.658206863057
"4776",488,83,405,188.481315091917,177.126755599573
"4777",499,90,409,194.73562346959,177.651973322073
"4778",491,90,401,201.667538916386,177.161417061537
"4779",480,92,388,182.754418054413,173.58068928449
"4780",489,81,408,191.219986940407,169.58744253555
"4781",476,83,393,202.507362377337,177.205801709473
"4782",474,80,394,196.366402913882,167.932780706229
"4783",479,85,394,184.589155147656,174.607705246324
"4784",491,87,404,184.168486475282,173.662196268809
"4785",474,84,390,194.867904768118,175.742541996987
"4786",496,94,402,187.395896294109,177.193692179208
"4787",481,85,396,198.184504631204,174.46928725352
"4788",473,88,385,198.206290151932,175.386572398945
"4789",483,94,389,195.866881545035,173.945297721001
"4790",489,86,403,185.851226417214,176.844766064817
"4791",483,78,405,197.134264922054,177.043005405117
"4792",492,91,401,198.854891635576,179.692046779947
"4793",501,81,420,190.193639588096,181.637113990211
"4794",476,86,390,191.08260033459,178.70340320407
"4795",491,91,400,199.175053095966,175.943973421211
"4796",487,88,399,192.745861637,169.974192287063
"4797",472,86,386,187.139422311368,177.164446030519
"4798",493,86,407,195.144441777555,175.931296050774
"4799",494,83,411,192.879052901537,182.939455030784
"4800",480,85,395,185.545041091093,176.23130457869
"4801",489,87,402,184.111444223363,175.470949632269
"4802",476,90,386,191.589413724029,182.988750811431
"4803",476,82,394,193.600774680314,175.73872778003
"4804",494,88,406,198.789765423986,175.823314588093
"4805",485,82,403,203.798107995732,177.36496771473
"4806",481,80,401,198.921570592498,174.773258446421
"4807",474,85,389,193.873629656129,176.714162282506
"4808",497,81,416,195.748761518179,178.378158726887
"4809",494,90,404,203.245598094424,180.085190114418
"4810",490,90,400,190.907773449233,173.420517534931
"4811",465,86,379,201.878782002079,174.802738217133
"4812",502,91,411,194.962711964289,183.315233690073
"4813",487,85,402,214.92711059833,179.790013677492
"4814",496,84,412,192.437315195773,175.364117930356
"4815",507,93,414,194.224348724516,172.361121009056
"4816",489,92,397,202.174672592877,180.433936448949
"4817",482,90,392,200.399134692608,180.864104116624
"4818",477,81,396,206.106867610628,170.526509974761
"4819",463,92,371,187.83712180909,174.317137036291
"4820",488,89,399,186.086623429516,173.680398959337
"4821",477,82,395,204.582052305064,173.929409710675
"4822",492,80,412,205.304771052512,179.813059172468
"4823",510,85,425,194.484880997964,172.844624262801
"4824",487,89,398,198.904286647985,181.088221161547
"4825",479,86,393,196.589212860294,173.78435843987
"4826",490,87,403,197.087999572354,179.018461419435
"4827",470,78,392,188.234293179521,176.104460401875
"4828",487,88,399,203.652933322524,178.524340431056
"4829",496,90,406,199.022245712404,177.799659456589
"4830",494,84,410,191.231862691264,176.951162260188
"4831",477,87,390,204.867386001935,175.809776851019
"4832",513,92,421,190.643895998352,180.689799088321
"4833",480,87,393,181.191383789097,176.146571778003
"4834",464,84,380,193.237708465712,176.029266839705
"4835",462,77,385,200.616082963954,175.638532462691
"4836",485,89,396,185.958347057735,176.412617169954
"4837",483,80,403,208.080314684499,179.962265211223
"4838",495,91,404,197.817181151715,170.199684313396
"4839",482,89,393,206.471297234804,173.129804949193
"4840",483,83,400,210.249407165098,177.419611255209
"4841",501,87,414,185.080642069948,184.05754097694
"4842",476,88,388,214.930982591915,179.907907364521
"4843",481,88,393,188.531520068136,176.322054055451
"4844",481,79,402,196.44355502498,184.129007901597
"4845",493,83,410,190.816465440108,175.441674744313
"4846",492,91,401,189.632279326402,176.87554434498
"4847",493,81,412,212.402807742667,177.811268256453
"4848",496,95,401,200.319942323646,173.126924915942
"4849",483,90,393,183.747537837366,184.085590219847
"4850",476,86,390,206.233871389911,170.775107676554
"4851",486,86,400,189.703742442995,180.560512930399
"4852",480,76,404,192.710237522874,175.695516693809
"4853",490,87,403,201.549047947818,181.751079578382
"4854",496,91,405,195.595301359976,183.564323782738
"4855",481,83,398,190.870636734109,174.262358048104
"4856",492,85,407,197.467205796702,174.982812752848
"4857",501,85,416,202.481878103741,176.956363029539
"4858",474,82,392,197.401898904324,178.576289064746
"4859",486,83,403,194.65888125442,175.815199178172
"4860",491,85,406,209.602081374437,171.776600383245
"4861",491,93,398,183.330696303658,185.629482718476
"4862",476,86,390,192.411551976461,172.645431203337
"4863",483,81,402,191.667208464218,175.907470084089
"4864",476,87,389,181.921397751402,178.30235047534
"4865",477,81,396,185.434770306253,176.154468804564
"4866",491,88,403,199.346561987197,168.437628400758
"4867",488,91,397,198.11149743899,174.309961689136
"4868",475,78,397,199.72470231069,181.812996794139
"4869",476,81,395,186.56924538325,171.079782665679
"4870",474,83,391,213.302336179604,181.860298718221
"4871",491,84,407,190.017402847489,173.654905601407
"4872",493,87,406,201.138752186716,178.501314272256
"4873",481,86,395,191.173366986344,182.033728242006
"4874",475,87,388,184.705401584412,171.286294030898
"4875",480,88,392,198.708206489385,176.737115993246
"4876",503,93,410,202.317713400192,176.982867405822
"4877",490,82,408,204.039391732304,182.409684553152
"4878",481,88,393,192.90774812506,182.054560366214
"4879",472,73,399,187.005930236147,181.468036374939
"4880",489,83,406,192.131446912899,172.576169835715
"4881",488,83,405,194.2825218765,174.936376649749
"4882",467,79,388,188.793630034204,167.146831788437
"4883",501,85,416,195.591508578114,174.831277144712
"4884",494,88,406,194.903795021316,180.582526917293
"4885",479,84,395,205.815120231319,173.58463786645
"4886",479,88,391,190.323903092893,175.238833075437
"4887",486,86,400,208.499629444517,175.902449801427
"4888",481,87,394,185.565971043513,172.828283316794
"4889",481,86,395,193.489897243646,173.993636232071
"4890",497,86,411,197.430330202618,179.822144494564
"4891",477,82,395,191.653139962455,176.235565868375
"4892",492,92,400,198.559800909529,185.548357420579
"4893",481,84,397,193.950403982548,183.892023873557
"4894",485,87,398,192.361458116305,168.747580304847
"4895",491,91,400,184.739429976614,173.491769598287
"4896",492,91,401,194.058169862779,173.558549446387
"4897",487,84,403,193.871002635793,186.985996646587
"4898",478,80,398,200.562938109782,177.519463584442
"4899",508,96,412,181.819629998767,175.504545236346
"4900",493,79,414,202.895773325248,179.127424039529
"4901",473,78,395,208.822401866768,173.274335455537
"4902",497,86,411,193.083005919842,180.254245201239
"4903",471,87,384,188.90505246647,175.716250903044
"4904",473,84,389,204.129822172535,175.905233856673
"4905",484,80,404,193.592399581972,174.222664999136
"4906",499,89,410,201.305882387366,170.68547596795
"4907",487,81,406,201.652746978448,179.385779149702
"4908",486,89,397,191.992378101757,178.49505431138
"4909",506,88,418,196.876407302526,178.756108491137
"4910",477,85,392,206.54066853153,182.787567404402
"4911",476,87,389,185.582493460997,176.542842474195
"4912",494,84,410,183.647467119205,172.032160187551
"4913",479,81,398,205.670447538559,172.000358784513
"4914",491,87,404,199.93867978557,172.263675111917
"4915",484,83,401,193.472857170489,177.421711134249
"4916",476,90,386,195.668821803628,171.789709315915
"4917",487,84,403,199.979832426515,174.608460750676
"4918",488,88,400,191.486032271894,169.621834543339
"4919",489,94,395,203.40771938647,181.908092698922
"4920",488,89,399,187.505858377656,180.40366097574
"4921",493,82,411,188.712543807552,169.843343217483
"4922",502,88,414,198.441808227593,170.932661563173
"4923",490,86,404,194.223484269633,172.979557851229
"4924",468,84,384,198.719063699176,176.822193138978
"4925",484,86,398,196.596239894209,174.989653741158
"4926",492,86,406,206.967834992962,178.233837530371
"4927",495,82,413,204.226973202815,179.936817436883
"4928",492,88,404,198.925149910103,179.351734095325
"4929",470,76,394,189.874138583057,180.955457560225
"4930",501,83,418,202.972764568435,174.025593613399
"4931",486,82,404,196.797594513503,176.175342388548
"4932",483,86,397,188.742965880776,176.812324183908
"4933",466,84,382,197.933860322661,183.056247975587
"4934",485,84,401,193.563953822557,175.661079080138
"4935",492,89,403,200.934400317187,180.975459223265
"4936",483,91,392,196.41476868201,176.281867701711
"4937",492,82,410,204.050792897409,174.591005173456
"4938",473,78,395,197.108614707791,175.162217280852
"4939",480,80,400,190.611754343794,173.241009153977
"4940",488,83,405,202.229219519042,168.474533342519
"4941",501,84,417,181.548034402467,175.805198327142
"4942",475,88,387,194.866912721523,176.078266425478
"4943",494,88,406,193.877607735802,178.987172875197
"4944",494,94,400,192.636637302942,173.995742871673
"4945",483,84,399,212.276401065923,174.353088779315
"4946",476,81,395,201.683727665162,175.745196359545
"4947",492,90,402,197.253025015533,176.744494766032
"4948",504,92,412,208.484740129245,171.020342246767
"4949",479,86,393,198.506161625797,180.002849058269
"4950",485,93,392,203.991930211329,178.070973248536
"4951",483,88,395,181.593183033404,174.961821249419
"4952",493,92,401,194.573039385529,178.941239064685
"4953",485,94,391,176.207820916901,176.805577772733
"4954",486,89,397,184.709035271582,175.397738701086
"4955",497,89,408,194.417075614317,179.183127279064
"4956",471,80,391,217.736797726514,178.262187269326
"4957",486,87,399,199.293733333124,178.373786693977
"4958",489,86,403,212.73402840568,178.494455248802
"4959",484,83,401,209.452088950334,174.226269313199
"4960",498,87,411,195.851735631196,178.965390091836
"4961",505,93,412,200.836341095838,175.175694995664
"4962",480,76,404,208.053578083136,172.500348662216
"4963",487,78,409,184.996471022835,173.272313522826
"4964",491,88,403,189.177396664895,176.15125815299
"4965",473,88,385,187.253298583342,179.69098754157
"4966",494,91,403,187.363515008552,173.116289260978
"4967",488,84,404,200.543150160539,176.509108492852
"4968",479,85,394,200.54133470796,179.858479518764
"4969",478,88,390,194.711867881774,180.447542418359
"4970",482,89,393,191.372934470072,177.32271138762
"4971",481,90,391,190.786527282094,174.465967555962
"4972",486,87,399,200.315876158045,171.219000777055
"4973",484,81,403,189.073333998217,175.190894827969
"4974",487,82,405,195.376646004218,178.391961248556
"4975",493,89,404,195.703247070399,173.629559181203
"4976",477,91,386,208.510000285245,181.278816615961
"4977",490,93,397,183.271465262135,173.88939372542
"4978",477,75,402,189.659503244277,173.300772762695
"4979",489,93,396,195.101919524202,181.994169571541
"4980",486,78,408,191.86687824289,177.184709191716
"4981",499,86,413,199.717359014203,177.140086789693
"4982",475,88,387,194.694979848091,181.827686825616
"4983",493,86,407,203.027577886928,180.918892617142
"4984",486,88,398,194.897636702826,166.319114037536
"4985",498,83,415,198.192023960801,171.656551227942
"4986",472,82,390,193.141874996032,171.043724775145
"4987",487,88,399,210.423969615181,182.238874524045
"4988",484,87,397,186.966171371811,176.115377946196
"4989",478,81,397,201.752526716448,179.595815990921
"4990",483,82,401,208.63813127811,176.674853823654
"4991",484,87,397,191.699950192238,172.50713107541
"4992",471,77,394,192.722516574035,178.443169983772
"4993",481,89,392,183.486415508183,169.032642273457
"4994",477,89,388,200.192212777656,176.89720901538
"4995",474,87,387,176.875929639959,180.896625914191
"4996",472,81,391,208.105854328601,175.401454621755
"4997",500,86,414,207.109659217083,175.966485443353
"4998",476,78,398,203.125849447813,183.404599519038
"4999",484,87,397,187.804721406321,176.848051766988
"5000",476,82,394,195.024413733128,178.162793833412
"5001",480,84,396,189.469498132421,173.98582637025
"5002",484,86,398,203.297256750699,168.359575112234
"5003",480,83,397,206.130009702305,175.290789471874
"5004",485,81,404,194.59252359746,171.425754158943
"5005",474,77,397,202.011510171845,176.597493928896
"5006",481,80,401,188.463490951733,177.412864532731
"5007",486,89,397,199.764696172479,175.443902248218
"5008",483,80,403,198.870184167672,178.3475531124
"5009",471,80,391,207.192802973536,173.770150423213
"5010",465,78,387,189.980110832903,169.675123800005
"5011",489,83,406,191.516135846649,172.184728220035
"5012",483,85,398,199.424069251382,174.380529554354
"5013",480,84,396,194.542354606628,170.558433284722
"5014",479,87,392,190.57610241827,173.415168728629
"5015",484,79,405,204.107899132968,176.188820097358
"5016",482,90,392,190.193583928688,177.416363804018
"5017",481,83,398,202.345503329744,175.790679742455
"5018",488,86,402,195.501103099442,171.324325987512
"5019",498,86,412,202.519578315109,179.318378346863
"5020",500,85,415,200.209865785202,178.724543810965
"5021",477,87,390,198.163078686481,177.690233939391
"5022",498,89,409,195.028553189523,175.307458537832
"5023",483,81,402,197.409194524665,170.961867951211
"5024",504,83,421,206.420806028076,169.351606882118
"5025",481,91,390,195.554912747986,173.512367771015
"5026",490,83,407,199.58639825637,174.782560051024
"5027",477,83,394,188.647357572879,174.927271965582
"5028",478,88,390,198.242536393458,175.55468742071
"5029",502,89,413,182.294980798777,176.851837706732
"5030",478,82,396,204.693321315438,170.372019395206
"5031",484,85,399,196.247407280706,178.769402899562
"5032",486,90,396,201.981867909008,179.648383018326
"5033",474,82,392,190.067793828554,179.118350327841
"5034",484,91,393,205.278871214581,172.672841125727
"5035",484,80,404,192.906330560928,180.23993892596
"5036",460,79,381,192.361875189482,173.347200393113
"5037",489,90,399,184.666096708631,175.750151810319
"5038",501,94,407,183.547426387102,174.445659727469
"5039",479,88,391,195.931423022496,179.30228836134
"5040",494,92,402,182.341779176342,174.898456536763
"5041",493,91,402,194.35280815704,176.138610653349
"5042",493,83,410,190.360007931616,172.368100290404
"5043",503,88,415,195.263835806915,179.811386506806
"5044",493,94,399,192.337083828097,178.319774063332
"5045",481,88,393,210.524474910934,181.195998709682
"5046",485,86,399,200.847470764055,171.785381351864
"5047",481,81,400,197.267408650163,176.237704437389
"5048",483,87,396,182.446846580175,183.976527856665
"5049",479,81,398,193.436491725035,175.599997603109
"5050",482,88,394,194.321780732991,175.324208301006
"5051",496,85,411,202.214665313323,177.173611398219
"5052",480,84,396,187.661737478021,176.415586104401
"5053",485,84,401,198.765604138891,176.006518323158
"5054",486,92,394,199.823698938853,177.789069830429
"5055",497,93,404,191.823363287073,182.78660814634
"5056",494,86,408,199.987478122454,172.272809057094
"5057",468,85,383,202.5535201039,180.382780504862
"5058",480,86,394,188.094656589764,177.313263140746
"5059",476,82,394,195.376959354897,176.879324131424
"5060",496,80,416,181.480013198355,177.187999446342
"5061",479,91,388,202.552479855024,176.131646103983
"5062",491,84,407,190.013249664997,182.507938419853
"5063",467,86,381,196.219572220979,177.308693747369
"5064",468,83,385,198.455395344805,178.479985649232
"5065",491,95,396,199.30506098778,175.428870807698
"5066",477,77,400,193.09330025595,176.124608560697
"5067",494,88,406,203.010208086731,177.917412650449
"5068",477,81,396,213.625253342507,176.979951844953
"5069",467,86,381,192.785310690005,175.879194663538
"5070",495,94,401,186.625933475011,175.733248090505
"5071",480,88,392,181.923733299607,178.295256481618
"5072",485,94,391,177.941048471238,172.904341438594
"5073",490,94,396,192.179905493389,177.84694508491
"5074",499,84,415,206.676887803098,173.852798595056
"5075",497,87,410,197.909312344936,173.935279717872
"5076",474,77,397,198.973023192175,175.393676775874
"5077",480,86,394,184.957780086808,173.209995049638
"5078",489,80,409,187.5635629046,172.158996726083
"5079",485,85,400,181.869604687721,172.208605854623
"5080",498,88,410,195.046949690792,171.74561994608
"5081",484,86,398,196.94773118808,177.832556861667
"5082",494,90,404,193.103127290448,178.418998293266
"5083",491,95,396,193.655776370689,172.438765802622
"5084",478,82,396,195.671974323665,173.093426734043
"5085",493,82,411,205.74976169386,173.517518399918
"5086",474,80,394,194.275875945646,178.737349882634
"5087",486,86,400,202.186733012461,174.539018479765
"5088",489,88,401,189.555906276777,174.697518829947
"5089",499,90,409,194.000523204821,172.15913958327
"5090",479,86,393,200.393760776732,179.805802329778
"5091",480,84,396,201.031214710487,176.450963694538
"5092",475,86,389,192.947572242834,173.975878431629
"5093",480,91,389,192.284644149046,175.802408109035
"5094",501,87,414,182.398449540351,177.038969345168
"5095",474,80,394,195.105062614629,173.597409467155
"5096",490,84,406,200.043745579978,179.787499805658
"5097",494,80,414,202.441514271258,183.713595316257
"5098",482,78,404,195.977421237131,176.364030644677
"5099",478,84,394,205.055516205872,180.213675946795
"5100",486,88,398,188.795481835108,173.054638739425
"5101",481,79,402,195.425866918996,175.330535784472
"5102",483,80,403,195.289300655368,176.38210995945
"5103",485,88,397,197.930787743815,174.900001608868
"5104",480,89,391,191.378327112138,173.088066997071
"5105",488,87,401,196.659334008091,179.660740185643
"5106",486,87,399,190.829058770659,177.170248720621
"5107",488,71,417,200.730723335007,181.400935342459
"5108",493,83,410,198.196764867425,182.886515334676
"5109",503,83,420,202.389130021607,171.249317439471
"5110",491,81,410,182.801145639122,176.946072828129
"5111",489,89,400,197.967261756671,175.471612625364
"5112",500,80,420,207.646916976361,178.246316551045
"5113",478,91,387,195.54875454043,177.688980094175
"5114",470,79,391,191.660272631507,182.550498282043
"5115",498,82,416,193.123794920789,174.940518387934
"5116",486,92,394,184.715698285136,173.304585370424
"5117",478,80,398,187.832370698564,177.672533583192
"5118",465,86,379,190.360912184091,180.543256849195
"5119",486,89,397,185.817378584031,178.154509727805
"5120",474,83,391,208.316390842122,179.515362934307
"5121",501,88,413,192.598069208751,176.461682267424
"5122",493,96,397,178.730136704596,178.099808046459
"5123",492,89,403,200.437377740972,178.047415842023
"5124",477,83,394,202.777622258951,177.82783940086
"5125",495,78,417,196.590117209121,178.864313607892
"5126",486,84,402,199.942625441055,179.217658624744
"5127",497,86,411,200.209254051737,179.740037194058
"5128",497,90,407,196.726045698084,175.431294168815
"5129",475,81,394,196.626523510116,176.311651723753
"5130",473,91,382,198.422346197262,184.426619873428
"5131",479,87,392,177.169245832143,175.766571729836
"5132",479,88,391,188.578747025621,174.819175702319
"5133",502,85,417,189.388378411125,172.106478616248
"5134",492,89,403,185.357143626182,175.705049801578
"5135",483,85,398,205.541657581156,167.94653318621
"5136",479,81,398,198.235149795295,174.206400009794
"5137",489,88,401,200.038020623939,184.239971851494
"5138",498,91,407,199.04398568235,171.843664787667
"5139",484,87,397,188.755356490356,179.473958512842
"5140",498,85,413,204.641176011697,177.732513784574
"5141",467,84,383,187.492344670271,174.168091991696
"5142",493,86,407,186.13423537175,183.80842252351
"5143",486,89,397,197.526015328871,176.246487650681
"5144",478,77,401,201.077546578367,169.528996548229
"5145",496,87,409,196.697480912892,172.733473384657
"5146",481,79,402,197.08553771171,175.168466680631
"5147",488,84,404,204.54110129875,174.974788386553
"5148",472,82,390,186.27214977714,170.804318605981
"5149",480,92,388,200.922727448412,179.778842909513
"5150",475,89,386,193.848833515387,171.058943359212
"5151",503,82,421,193.359944667611,179.791683655748
"5152",486,88,398,191.341053567055,175.453055295242
"5153",494,95,399,194.454024422089,177.155019879369
"5154",483,85,398,196.174164232393,181.521655889893
"5155",491,89,402,210.277163272376,178.25652038305
"5156",485,89,396,190.965277469387,176.894631392498
"5157",485,85,400,193.291511457706,176.451897550775
"5158",491,83,408,191.983087372364,175.305147338871
"5159",489,89,400,204.308516212658,171.511360185705
"5160",476,88,388,184.025863434013,173.501502717533
"5161",482,87,395,210.976371623628,175.832478567935
"5162",475,80,395,195.790561685019,180.849586349801
"5163",491,86,405,194.761400557282,180.79082896466
"5164",469,90,379,193.962632076463,177.684598438617
"5165",477,89,388,193.212935658946,176.377748863056
"5166",484,87,397,188.29325034167,173.448220300275
"5167",480,76,404,214.026236579967,181.110579505405
"5168",483,85,398,195.691253515702,181.828686902646
"5169",480,87,393,199.00592429382,174.572705317484
"5170",479,82,397,192.996231247382,176.825366644508
"5171",487,82,405,195.511503272358,175.672908719101
"5172",488,92,396,190.675070117107,170.193201217104
"5173",475,85,390,183.034100448055,179.697957556285
"5174",472,83,389,190.861864705031,174.30989674714
"5175",487,92,395,190.365635083359,181.209061183548
"5176",480,84,396,204.528701516719,174.167814494592
"5177",483,80,403,191.135659398978,176.036543245937
"5178",486,82,404,198.342056500306,177.248503761904
"5179",477,84,393,188.427211482992,173.29343910708
"5180",484,90,394,197.612463654564,179.43354788866
"5181",493,82,411,197.037583643558,172.693366587169
"5182",487,79,408,202.779516718102,181.433233399957
"5183",486,86,400,199.35878575434,173.648895783239
"5184",483,85,398,202.752712774602,176.541839051838
"5185",476,82,394,183.318727139222,166.308691461342
"5186",481,86,395,184.015377139535,180.996783797697
"5187",477,84,393,199.3853444801,172.391758205472
"5188",502,87,415,199.016280591656,177.799557544974
"5189",485,91,394,195.663546297001,175.31403082057
"5190",481,88,393,193.794087280159,177.271864361095
"5191",487,84,403,195.433094154866,173.430786147747
"5192",474,81,393,188.250406237075,174.432000135702
"5193",494,85,409,189.591037057764,180.76985801546
"5194",474,87,387,169.88957322387,177.199724402819
"5195",492,86,406,199.7994285083,186.145021493875
"5196",469,81,388,195.322838895577,173.915557280595
"5197",476,86,390,185.9234254393,180.229461915458
"5198",464,88,376,200.020135142743,175.391046453187
"5199",484,81,403,190.502126921,177.711351795555
"5200",469,85,384,188.059808866644,180.562445130883
"5201",478,88,390,181.177575837488,179.336828695355
"5202",486,84,402,188.919579294802,179.465718420821
"5203",478,80,398,195.086905207514,178.036514069581
"5204",474,84,390,197.079774907484,179.325664116205
"5205",483,84,399,202.938279599024,173.930159771792
"5206",497,88,409,193.133426611086,179.488208395315
"5207",482,85,397,205.582163705211,168.90454240861
"5208",496,90,406,199.885616101151,180.029481555353
"5209",495,89,406,194.019970760335,180.401732217127
"5210",482,90,392,201.648410569935,178.483869027928
"5211",488,81,407,192.021081660357,177.701717097604
"5212",483,92,391,193.153218682037,169.936148540668
"5213",496,85,411,198.131343815066,181.441648446809
"5214",482,81,401,201.035649539147,178.874439275083
"5215",496,88,408,185.299028519845,174.46969530842
"5216",471,84,387,215.907884200402,179.686334895714
"5217",502,88,414,193.47430111495,178.131394732041
"5218",493,89,404,186.547790838223,181.414934227782
"5219",477,82,395,178.903510697814,176.778951094169
"5220",491,88,403,178.517134242899,176.234460452527
"5221",514,90,424,200.908485188847,183.891190731215
"5222",477,89,388,202.37230084127,178.462435990548
"5223",475,84,391,194.922987201303,178.625271998043
"5224",494,87,407,194.687315826869,176.289345107012
"5225",497,82,415,202.576092238782,172.414712936954
"5226",487,81,406,196.558986541515,180.878066739836
"5227",476,85,391,190.229365934891,180.216977618873
"5228",469,84,385,213.906136812513,175.41523432576
"5229",477,82,395,205.325983885523,175.495850621183
"5230",479,85,394,194.301285204629,173.657996755391
"5231",487,92,395,196.597274134286,182.143500459061
"5232",488,88,400,192.888052749196,173.554247877366
"5233",473,83,390,187.333095016446,171.294367587863
"5234",482,80,402,202.693477148777,175.409180051893
"5235",471,79,392,187.991672735571,178.917579229771
"5236",478,85,393,200.958018987043,186.710091937452
"5237",484,77,407,196.336745285331,179.869382520453
"5238",478,88,390,188.423326543409,174.574800993706
"5239",496,87,409,215.299321124392,178.705482849635
"5240",469,87,382,183.39413403885,179.842086163379
"5241",482,82,400,212.271652206803,182.744750438564
"5242",471,84,387,202.602170629109,180.635365480208
"5243",483,82,401,204.262282977965,174.768032636114
"5244",486,92,394,198.88829481237,179.104634775553
"5245",485,89,396,188.144905505315,169.521555421093
"5246",473,83,390,193.879177538897,176.73014255065
"5247",483,83,400,186.895113512165,178.268357736726
"5248",477,88,389,190.418004664502,180.468264606157
"5249",496,88,408,194.828225367645,183.029591292136
"5250",486,81,405,188.159976241308,163.96012546412
"5251",490,83,407,198.872887456871,177.368953120926
"5252",488,93,395,195.22957903278,178.164003331585
"5253",465,80,385,191.077491372793,177.111371315528
"5254",481,91,390,202.264660192253,175.618852544414
"5255",490,92,398,199.51577818548,172.493985298685
"5256",480,82,398,194.848970642254,177.899764657082
"5257",494,92,402,212.503716961527,177.468348003945
"5258",496,81,415,187.441944731789,178.574379013276
"5259",475,87,388,187.171246328987,177.693577231883
"5260",487,87,400,195.521811847303,178.073550114399
"5261",489,96,393,192.11777505941,178.125956975408
"5262",480,75,405,198.356305247998,178.51985511766
"5263",488,84,404,180.930797012496,176.780531501295
"5264",493,89,404,194.347470009493,176.332810564748
"5265",472,86,386,207.139692760762,182.785130880582
"5266",476,81,395,204.213573241369,164.074416613721
"5267",473,91,382,198.083341562079,177.4670553777
"5268",480,78,402,190.069864244974,173.024831587162
"5269",483,87,396,203.868061604906,172.928163717942
"5270",480,83,397,208.383692876304,180.763307211516
"5271",490,86,404,200.145059481887,175.14481348567
"5272",486,84,402,200.577502183807,172.862101601226
"5273",485,92,393,190.283855703152,179.286556860658
"5274",492,86,406,203.701753218338,178.781619377038
"5275",500,97,403,188.571120376534,181.599955782169
"5276",499,96,403,202.946341875456,177.537142174104
"5277",483,82,401,202.801072675691,174.415224191799
"5278",483,92,391,190.82645288656,176.572529432328
"5279",503,82,421,192.801597248376,172.104825823081
"5280",462,77,385,200.961035045811,183.359834585118
"5281",495,85,410,190.501037354866,172.401756195088
"5282",500,84,416,193.75045831473,175.008814493354
"5283",492,84,408,191.399531361063,179.662454559265
"5284",483,88,395,197.034568659704,176.258249507478
"5285",484,83,401,204.145409312035,175.475665642924
"5286",480,91,389,189.131505247189,175.160541895073
"5287",495,85,410,190.625558961854,176.164800316745
"5288",483,79,404,196.161050215398,179.698742911775
"5289",488,83,405,188.541616033981,174.569699008168
"5290",473,83,390,195.712888662695,174.758536086781
"5291",488,92,396,192.868806128375,175.923421161811
"5292",488,83,405,210.532700116283,176.419955718666
"5293",470,77,393,209.946092202772,176.200044954162
"5294",483,91,392,196.69792287821,178.886691719199
"5295",480,90,390,196.073364217684,172.984366789017
"5296",475,83,392,184.990287797901,180.167940669367
"5297",479,88,391,192.662785963765,179.010989054206
"5298",483,83,400,193.466318825398,175.527098481464
"5299",486,87,399,195.592746242679,184.970505999789
"5300",478,89,389,194.337845136689,179.913977302762
"5301",482,89,393,196.644465653524,182.118134849266
"5302",487,83,404,190.232182848431,172.523860025306
"5303",490,80,410,202.861621236095,177.642677228238
"5304",480,89,391,190.60848398863,177.910268129575
"5305",478,84,394,211.094546418691,176.649108108185
"5306",473,87,386,202.172251787229,180.144912817882
"5307",496,89,407,195.687520784452,177.18512665679
"5308",490,84,406,186.117976904437,180.968789549931
"5309",479,100,379,199.729702240749,180.028301559851
"5310",471,81,390,195.818916475864,175.037429684813
"5311",481,86,395,191.012350815868,177.894691444348
"5312",503,84,419,203.468760813686,178.848144683019
"5313",483,85,398,199.236606662864,179.651911964122
"5314",463,79,384,192.028360256715,182.266766896959
"5315",493,91,402,181.719531839268,177.913392251986
"5316",484,86,398,186.42068693844,175.93624427028
"5317",481,88,393,194.109634618253,170.177966793059
"5318",476,83,393,188.144157810735,179.711945993084
"5319",512,92,420,190.644152067357,179.497538198827
"5320",491,91,400,185.548641858019,172.658041922149
"5321",483,90,393,181.753075251336,183.088929651618
"5322",478,85,393,191.990899839203,176.574501063091
"5323",491,86,405,200.201198741789,178.819158774885
"5324",493,85,408,196.147159052486,179.428173759571
"5325",479,82,397,196.030776078253,174.412069883824
"5326",487,85,402,209.516372946906,173.81502678238
"5327",495,79,416,200.791427297192,175.768313090886
"5328",486,78,408,192.60441930714,180.36119239803
"5329",481,83,398,206.93727172256,178.601140778969
"5330",479,92,387,197.21364174807,174.639192681391
"5331",488,87,401,197.751471615893,175.307716541489
"5332",483,89,394,202.95851144973,179.63019760208
"5333",490,90,400,186.695568846629,180.055493094273
"5334",484,80,404,197.834681880185,177.624567391443
"5335",489,83,406,204.455121666428,176.828233010811
"5336",475,85,390,203.727994377528,170.941467066205
"5337",497,91,406,188.887437758596,176.856002813937
"5338",483,92,391,190.522988614601,178.099640475223
"5339",475,84,391,203.469990183755,177.924602587621
"5340",501,86,415,198.589950397111,179.30057417644
"5341",482,92,390,209.010357822411,176.105749704944
"5342",490,86,404,183.940328897238,178.944876584907
"5343",504,86,418,194.209702584308,179.704157213962
"5344",490,85,405,201.469598290189,182.470575003723
"5345",484,85,399,196.774389147464,178.332889333962
"5346",461,80,381,195.513836757077,170.866811574303
"5347",483,84,399,200.949729378571,179.305398059491
"5348",497,89,408,190.212802945062,177.210417602178
"5349",482,90,392,178.934551497562,175.094270083596
"5350",491,84,407,192.56804459791,176.234062192547
"5351",491,88,403,201.598528112873,180.268906989406
"5352",468,83,385,197.788950095573,173.448948953742
"5353",488,84,404,207.255215262486,180.907300153095
"5354",481,85,396,195.459586268265,173.721302677068
"5355",498,85,413,196.884247455016,174.581022271455
"5356",483,80,403,195.210086319291,182.496499363599
"5357",492,88,404,187.131052812014,177.087967806289
"5358",494,89,405,202.184447652946,176.633713560099
"5359",494,91,403,189.989159746456,179.198254030458
"5360",473,79,394,182.914172223396,174.372713273005
"5361",489,98,391,201.867050184983,173.407736332048
"5362",475,79,396,196.078063331588,174.837574668637
"5363",493,82,411,200.719353264319,176.117613580524
"5364",486,81,405,194.930350433854,171.054381031261
"5365",483,79,404,196.865108331736,172.218361583364
"5366",503,96,407,193.785421272315,178.020215046274
"5367",486,86,400,186.889756359847,172.564768324904
"5368",477,79,398,209.051133561497,174.177730785292
"5369",482,93,389,187.904849439282,181.86616444879
"5370",486,83,403,187.804003316841,180.800609113126
"5371",485,90,395,205.608241816965,174.457270752372
"5372",472,80,392,195.505547335432,180.98717661384
"5373",501,88,413,202.963537622544,177.002039238791
"5374",494,93,401,189.48454766836,170.918337239723
"5375",485,80,405,201.072638106964,181.00142846643
"5376",476,83,393,191.202404338281,179.991629891339
"5377",484,85,399,198.251659143859,176.594591197163
"5378",491,85,406,204.218924754409,180.897063087902
"5379",480,82,398,179.665793200092,174.546747828432
"5380",487,83,404,199.347764516649,174.842957307115
"5381",472,78,394,199.562814187177,173.339002664552
"5382",493,89,404,196.478752168155,178.968786436591
"5383",487,86,401,191.919285981025,184.062294137277
"5384",498,86,412,200.372820493623,178.669618812289
"5385",473,86,387,199.786317349175,176.404151392886
"5386",475,86,389,185.91086065897,173.178241281589
"5387",507,91,416,193.196528022811,172.04084926703
"5388",467,81,386,192.173988049087,183.232612257708
"5389",479,87,392,201.105256135161,172.57501267073
"5390",480,83,397,194.718782187866,171.849905340461
"5391",500,92,408,198.153444329073,175.687337400126
"5392",490,92,398,194.450290998363,177.694743387893
"5393",480,87,393,195.753763081973,180.317749132632
"5394",481,87,394,186.272810117266,175.755452226013
"5395",503,92,411,192.796492016655,178.412360029057
"5396",505,94,411,199.012337044155,177.135364757955
"5397",498,95,403,187.085926959509,180.664055277859
"5398",471,75,396,197.853088744534,174.513744058294
"5399",482,81,401,193.331737256748,179.193469242306
"5400",486,80,406,211.718120672225,175.101997896074
"5401",479,83,396,189.90522728335,178.333028987723
"5402",491,83,408,185.180936756579,175.292709741763
"5403",479,86,393,198.86941696922,175.493829550555
"5404",483,81,402,206.502423853115,179.425834651598
"5405",483,90,393,189.939589816594,180.048596066333
"5406",503,90,413,190.245781513147,171.602121828148
"5407",484,82,402,194.354232523954,175.434990912817
"5408",489,90,399,185.611964317215,176.196557928952
"5409",491,83,408,178.128910676425,180.702347394286
"5410",483,85,398,201.548598398793,176.840268357687
"5411",487,87,400,182.244717045798,178.795849475528
"5412",493,95,398,190.987711681853,180.116282060164
"5413",485,87,398,192.387365293629,175.04748256512
"5414",466,76,390,206.186736135364,175.023954826929
"5415",481,84,397,204.005234981631,178.440816137451
"5416",475,82,393,210.739949069227,171.454984070124
"5417",488,83,405,192.85363785953,175.261035622604
"5418",489,92,397,183.938246636446,179.769822460522
"5419",477,89,388,190.598187657686,169.728660583964
"5420",490,87,403,184.898835542434,170.873059122283
"5421",481,93,388,204.091511030581,184.211953900244
"5422",474,75,399,203.879319593258,174.781691129386
"5423",488,82,406,197.920847465366,174.492681351762
"5424",484,88,396,185.978625557603,181.650793967472
"5425",498,89,409,188.141273027958,172.576099026322
"5426",498,88,410,189.268066418155,170.838872827069
"5427",478,86,392,189.049399177623,174.401760933568
"5428",492,89,403,202.850193431225,171.822588047014
"5429",487,94,393,197.846967893113,182.278464137012
"5430",468,79,389,206.077297613394,171.432472507545
"5431",480,89,391,186.741080814655,177.472336851984
"5432",479,87,392,196.702525358696,173.306160930524
"5433",471,80,391,204.466696800977,173.150816545742
"5434",505,94,411,196.624992809947,175.004012311716
"5435",494,86,408,192.741934541952,179.267167171339
"5436",479,86,393,184.604214755531,179.317473126989
"5437",497,92,405,197.11468317741,178.346267541859
"5438",463,74,389,187.169382122116,172.573036327612
"5439",484,84,400,220.855837846493,173.578796909255
"5440",500,87,413,195.435437291459,167.645459643187
"5441",483,87,396,182.966206712392,175.295261986945
"5442",487,89,398,204.119637318561,179.578146050629
"5443",507,90,417,192.231207502681,179.585974062995
"5444",493,87,406,186.305478038143,171.566964051942
"5445",468,89,379,186.85734166623,179.868284824117
"5446",494,92,402,190.176886184178,181.052450152137
"5447",495,92,403,194.744382275191,173.812947718004
"5448",501,81,420,186.960388095228,174.239469767454
"5449",481,75,406,187.340878813702,176.842381747009
"5450",480,91,389,194.20749945487,174.668966974409
"5451",497,92,405,201.677344101374,175.14146956375
"5452",503,85,418,192.90519452849,183.559803094355
"5453",499,83,416,197.916656445303,172.067795135438
"5454",494,93,401,188.388961205617,178.867847128786
"5455",490,86,404,203.06487384535,175.231876891958
"5456",508,86,422,203.251892794325,176.084454055008
"5457",486,83,403,195.545156901847,171.528728539468
"5458",483,81,402,184.806614965601,179.444494506423
"5459",482,85,397,200.067770994416,181.55471632772
"5460",483,81,402,201.234576290375,181.72685097131
"5461",482,83,399,209.734592829969,176.12551053968
"5462",478,79,399,208.493350503824,174.313475898003
"5463",483,87,396,198.306852187163,174.36400653462
"5464",475,82,393,187.675644441752,180.412039066878
"5465",497,95,402,198.466123427556,179.678697827875
"5466",484,86,398,201.5465326277,179.470778141606
"5467",476,84,392,201.004904902899,175.610466740475
"5468",473,80,393,192.263807532045,176.050438812511
"5469",485,90,395,207.619878485099,174.034051949956
"5470",472,76,396,202.603534922144,176.072580247006
"5471",470,82,388,200.954266469238,175.044232650845
"5472",475,81,394,191.485003699994,175.262815249321
"5473",496,84,412,188.73398786423,180.893555037963
"5474",496,88,408,185.017787699877,172.884140703939
"5475",494,92,402,192.712121812969,175.138023430359
"5476",491,96,395,197.61321593085,176.673965868236
"5477",473,81,392,206.062142536361,178.892344232352
"5478",482,77,405,200.545836492023,180.577011049363
"5479",487,78,409,187.712694787588,177.324153957058
"5480",489,82,407,199.621745689188,175.911159907954
"5481",481,84,397,200.863923450718,183.77662705136
"5482",485,78,407,193.993851625989,172.973570903605
"5483",478,82,396,203.184090024368,172.522352099474
"5484",465,90,375,204.164811528461,179.426053683652
"5485",476,88,388,194.687800454144,174.995180140362
"5486",485,84,401,178.81907047198,179.219499234514
"5487",484,85,399,196.003345754682,180.184760283196
"5488",491,89,402,187.019073935966,178.756098983611
"5489",486,92,394,197.08593149336,178.808783138982
"5490",487,84,403,197.324704876911,174.341456205406
"5491",476,87,389,207.548176291038,173.791854926224
"5492",473,84,389,191.145393138058,176.149445704243
"5493",489,87,402,206.001061575262,171.084219044862
"5494",490,93,397,187.090870087153,173.392541694982
"5495",478,82,396,191.501185032379,178.079140513997
"5496",482,79,403,193.676499453517,178.051401101095
"5497",488,92,396,197.212482334759,170.300339453782
"5498",486,87,399,205.134055964468,172.707908309881
"5499",485,84,401,199.025858011348,175.08373578691
"5500",498,91,407,183.02708379914,176.120571090511
"5501",505,87,418,191.772867790559,173.405967748
"5502",476,81,395,202.387815980913,179.500405504458
"5503",473,85,388,191.081738522517,173.247231401063
"5504",471,88,383,191.255342377243,174.226600385176
"5505",489,90,399,196.283505898254,177.635258569843
"5506",489,85,404,187.441636498422,176.57919685144
"5507",482,84,398,200.182693489306,168.781336135596
"5508",489,91,398,189.125557630793,176.148872255872
"5509",486,74,412,199.007145118161,172.091261036094
"5510",496,88,408,201.684102581418,178.076886924622
"5511",488,93,395,191.305379988414,174.841342072807
"5512",478,85,393,199.0554697115,178.664443559437
"5513",492,86,406,196.253804245886,174.668721850773
"5514",486,85,401,189.023301778738,181.991827965607
"5515",486,89,397,199.973352705692,174.807217122251
"5516",464,82,382,201.59499565356,174.4472946326
"5517",472,84,388,189.789784546748,180.097251983515
"5518",483,82,401,202.360272512046,180.628769552348
"5519",492,87,405,199.063508362847,177.138021632982
"5520",492,89,403,187.183531974961,177.453188409924
"5521",485,80,405,180.971301731063,179.552952452103
"5522",484,85,399,189.864724397835,174.078892486125
"5523",496,88,408,198.269932740756,180.956340238482
"5524",477,81,396,183.043062193371,175.485085322958
"5525",498,88,410,193.020848796248,177.425948108074
"5526",491,86,405,192.55172010019,178.270689422185
"5527",492,80,412,206.435613929851,178.269228673867
"5528",494,92,402,196.105717262116,178.53662905725
"5529",477,76,401,203.020572873984,174.178022639786
"5530",479,89,390,196.306646198914,180.000988538265
"5531",480,88,392,190.059840553894,177.490885026507
"5532",492,87,405,205.448866906437,180.677600354304
"5533",493,81,412,194.366842491389,177.21957834148
"5534",482,79,403,205.787628217768,181.127133775978
"5535",507,79,428,194.277792243932,177.767848666934
"5536",491,87,404,189.93050623027,167.677363234339
"5537",479,90,389,185.916618853291,175.51845574583
"5538",474,85,389,205.603336942188,178.497754498073
"5539",484,84,400,192.569473413301,168.134916997579
"5540",466,83,383,188.40995230359,178.874236527778
"5541",481,82,399,174.702726269498,171.038007490453
"5542",493,80,413,184.235747965977,171.792019537591
"5543",483,85,398,197.252446044451,174.124075168876
"5544",474,79,395,206.927955005499,170.293934531568
"5545",492,87,405,185.792196410395,177.742657264724
"5546",485,95,390,193.032156773987,176.833942966987
"5547",461,88,373,191.81883225281,179.980918300984
"5548",489,88,401,204.461634258099,177.985625210102
"5549",474,82,392,196.924996003155,174.010915003295
"5550",490,88,402,208.518733174894,173.120346395287
"5551",487,85,402,184.478525770908,176.21324161955
"5552",496,95,401,188.39744330318,179.424557357231
"5553",482,86,396,187.499335502024,183.025147487501
"5554",498,92,406,197.856305158456,171.94021800953
"5555",467,87,380,180.964054596787,183.596665673312
"5556",483,92,391,178.939886731371,180.167884328847
"5557",501,90,411,188.611768738933,172.123492914124
"5558",477,84,393,207.818049851969,180.581747912785
"5559",488,90,398,196.539067597,177.050784395479
"5560",499,93,406,191.705190682107,175.431045231338
"5561",474,78,396,198.276829523374,180.844611326732
"5562",486,84,402,191.584238787877,182.243493263145
"5563",491,91,400,190.98777212105,177.558774941996
"5564",472,80,392,191.374708249824,174.717472203409
"5565",473,85,388,174.796804098564,173.472316831357
"5566",473,91,382,201.763888862658,173.426463802113
"5567",482,84,398,196.789656968731,176.55421684463
"5568",484,89,395,199.816576341045,174.357343921684
"5569",485,85,400,186.004088304163,175.623641175125
"5570",504,95,409,190.870136910089,172.487882507966
"5571",482,87,395,188.424979324557,176.5253210436
"5572",470,78,392,189.403328282602,177.067159070595
"5573",498,86,412,190.787993000653,175.940036616225
"5574",481,91,390,193.017010766496,177.270316383015
"5575",484,89,395,184.202627477255,177.821359708637
"5576",487,88,399,200.660588803112,180.279607776505
"5577",503,81,422,186.188596775435,173.768269479344
"5578",484,84,400,199.814725586068,180.716531430919
"5579",497,90,407,190.349182758566,180.21930122193
"5580",480,87,393,193.090698739011,175.471457036597
"5581",472,84,388,185.492603313341,178.276554561197
"5582",476,82,394,199.015329984187,182.434575462483
"5583",492,83,409,205.569240455418,178.362139909219
"5584",482,88,394,195.007683079549,181.98555684661
"5585",489,87,402,187.219135008464,172.159949438311
"5586",499,90,409,182.960164591127,170.270483036748
"5587",489,91,398,197.859362840494,177.764099230771
"5588",493,93,400,206.162912925756,178.255429643981
"5589",478,76,402,196.322311053053,176.123650918605
"5590",480,84,396,182.629489796406,189.321509402742
"5591",490,86,404,187.693387021573,179.465622528329
"5592",479,84,395,205.885030186761,172.170047079198
"5593",478,83,395,186.903297515039,178.638132894116
"5594",494,87,407,204.838910033928,181.402377319274
"5595",481,88,393,189.165938636844,178.054221051479
"5596",492,84,408,179.223482943643,173.517012478848
"5597",482,96,386,188.674509638735,168.926639335008
"5598",471,83,388,193.709141330602,177.820363566344
"5599",485,85,400,197.092809069504,173.115819798005
"5600",492,91,401,182.158350618044,183.684294855279
"5601",475,81,394,206.839829343739,177.831437959577
"5602",484,80,404,193.718937501128,175.021124129382
"5603",485,79,406,195.125784791691,178.009651367318
"5604",478,81,397,205.889774820956,173.128368935515
"5605",485,89,396,176.716409885165,177.98260038672
"5606",480,76,404,204.526558608559,184.679982450286
"5607",473,86,387,192.030737458943,176.985644630043
"5608",486,82,404,200.786264555591,172.448779748711
"5609",476,81,395,199.921916838529,178.666825621012
"5610",481,83,398,191.480460536717,172.070247050931
"5611",495,100,395,188.908308909569,175.908347718507
"5612",480,83,397,197.924418942628,181.117674347186
"5613",468,83,385,193.00963507158,173.008598784628
"5614",483,85,398,213.614401783755,180.808999194719
"5615",489,82,407,211.865029042245,172.305755021351
"5616",475,82,393,205.029206826414,180.559109118916
"5617",470,86,384,209.153744656556,179.190057104328
"5618",491,86,405,187.092650691746,178.828528867048
"5619",488,84,404,210.238195441309,169.287498381055
"5620",486,88,398,189.131917826045,181.965613333961
"5621",487,86,401,193.673336144177,179.459041626582
"5622",498,87,411,202.811812527589,175.124907361241
"5623",476,83,393,192.984144273057,182.853462103278
"5624",500,81,419,199.564155029993,179.930437425813
"5625",484,74,410,201.875115421042,173.39395858923
"5626",499,85,414,201.049651880811,176.70672103134
"5627",475,78,397,194.623454384011,180.42668761614
"5628",468,79,389,207.332393444315,177.24303447074
"5629",497,86,411,183.725245057208,171.796449670345
"5630",490,93,397,204.937762919679,180.089589108712
"5631",477,82,395,196.178566244088,177.825132786893
"5632",482,86,396,188.634482262078,179.000405404693
"5633",479,90,389,182.610465914264,177.140527793693
"5634",471,86,385,195.973213991061,174.001151784416
"5635",483,91,392,194.007843862037,176.554072734395
"5636",496,85,411,197.885987680887,177.588810964446
"5637",491,88,403,196.235191117514,175.341784121527
"5638",484,91,393,211.342966229517,178.087570635763
"5639",481,87,394,196.436906134339,177.652902211341
"5640",505,93,412,191.115851954708,169.06490442514
"5641",497,95,402,182.055401736814,176.249767829957
"5642",474,77,397,190.515437531807,180.346447580733
"5643",487,85,402,195.166259741682,178.762106422344
"5644",503,84,419,194.322509488454,176.627193281841
"5645",468,82,386,198.822182379679,175.7592836001
"5646",484,84,400,198.757348016266,179.760193041218
"5647",492,104,388,189.6483741351,181.077507089299
"5648",478,89,389,205.115549187099,174.834207604399
"5649",480,94,386,195.235812070287,175.699266123879
"5650",492,83,409,193.875973200657,180.957029255509
"5651",491,93,398,187.122542053573,170.025817571859
"5652",476,85,391,197.874228105288,176.628951966449
"5653",502,97,405,186.140714330755,175.291861064208
"5654",484,80,404,193.337916317303,176.749362309257
"5655",474,90,384,201.706485166531,181.561887034656
"5656",494,84,410,195.678853660069,169.385107932132
"5657",483,92,391,194.234381233088,170.773804600628
"5658",493,94,399,205.253901282677,175.706807792932
"5659",488,85,403,187.626023249382,168.904549893425
"5660",494,87,407,199.615008181016,177.623110621318
"5661",476,88,388,196.994162533329,176.873615193846
"5662",508,85,423,190.16978940305,180.156247938524
"5663",501,88,413,197.141177258397,176.540762285694
"5664",486,81,405,183.561390998366,182.108444658069
"5665",476,89,387,201.85783970323,173.815959551707
"5666",468,83,385,203.107534631743,177.968027574473
"5667",470,86,384,187.047013416171,182.346386667032
"5668",483,78,405,202.60597458183,179.238534845997
"5669",491,88,403,185.582874373399,180.900032646044
"5670",499,87,412,206.101875735207,174.790754658042
"5671",511,90,421,183.844295362294,180.939213591976
"5672",498,83,415,193.648910012925,171.163542923041
"5673",500,96,404,178.971159157328,169.689652372816
"5674",488,83,405,190.633076821742,175.681076443477
"5675",481,82,399,197.692186166832,177.889228913057
"5676",485,83,402,197.446516658159,175.992759443424
"5677",504,90,414,191.243304472278,173.777425494159
"5678",492,78,414,192.701550239803,173.511896557899
"5679",484,90,394,205.075573475493,170.07736574764
"5680",491,90,401,205.752254981582,175.401351176626
"5681",476,85,391,196.497526860086,174.21174028304
"5682",504,88,416,196.922974926574,172.385455275247
"5683",476,87,389,179.955015020766,174.923811661033
"5684",500,91,409,187.796749453549,176.780444732789
"5685",490,87,403,204.559517161858,180.657498392673
"5686",486,90,396,195.056999576572,169.29359607195
"5687",474,92,382,191.014500352864,174.211987985845
"5688",483,83,400,205.98399947618,169.794717596186
"5689",483,80,403,201.55119076104,174.060915787612
"5690",482,86,396,178.818419272489,171.437421865745
"5691",480,87,393,197.77004279367,177.041030856002
"5692",495,86,409,194.838218472318,177.294711756664
"5693",474,82,392,203.775303737159,176.102609304332
"5694",470,74,396,212.454962826723,172.656384269789
"5695",484,76,408,185.349047869682,174.64452465347
"5696",491,89,402,190.248220509278,177.691659024066
"5697",478,82,396,203.901565251181,175.502657593111
"5698",487,81,406,199.487115289773,176.06136103094
"5699",478,83,395,184.49381508006,175.679310126945
"5700",474,83,391,194.010744417158,176.928346200907
"5701",492,85,407,209.797361899254,173.058181745167
"5702",503,89,414,198.394371048098,179.582024347855
"5703",479,83,396,200.561013386185,175.386592490183
"5704",474,86,388,200.147347156407,174.971900834664
"5705",491,79,412,186.638548250026,175.816462685575
"5706",482,86,396,191.199171936954,174.244272996248
"5707",472,77,395,201.083968061574,180.369993942841
"5708",511,91,420,201.434240752574,179.746530644989
"5709",482,81,401,192.532882644488,179.754807389101
"5710",497,86,411,179.400084660141,176.037487921275
"5711",472,84,388,207.528854413858,174.687431804163
"5712",491,91,400,191.669757877519,172.96759385031
"5713",481,81,400,198.485958676217,171.090879010071
"5714",483,88,395,187.567484177246,179.088033470566
"5715",475,88,387,184.38896688235,178.890443096396
"5716",462,76,386,202.308926407552,176.174981938839
"5717",480,84,396,195.947294306664,177.575678087805
"5718",481,85,396,199.172111485742,175.427655947796
"5719",480,85,395,196.888995225829,173.449336080432
"5720",487,94,393,207.474262256449,170.040551187184
"5721",486,89,397,185.244650770505,176.631616987677
"5722",480,87,393,189.273041099597,177.456522506735
"5723",496,93,403,195.688134115479,172.8697533571
"5724",472,79,393,209.792830590274,168.76100336229
"5725",467,84,383,188.020684556328,175.049811244225
"5726",485,84,401,195.780951075891,174.379160693554
"5727",481,83,398,195.829836694386,176.601010034831
"5728",494,97,397,200.754782251303,176.809745920898
"5729",480,90,390,196.675998736233,169.832595013252
"5730",464,78,386,171.77438467451,179.262538807756
"5731",469,78,391,195.52640919015,174.153155340816
"5732",502,87,415,214.591963069563,174.521697349165
"5733",503,91,412,202.859522994945,175.17034722309
"5734",477,92,385,194.195594542287,176.137759938886
"5735",480,79,401,206.957260803964,179.369827186255
"5736",504,83,421,197.776461833972,174.728582773008
"5737",471,84,387,194.098919936058,176.374093686282
"5738",490,93,397,178.056290951762,176.983091420174
"5739",484,88,396,191.770946596897,175.766520612657
"5740",459,78,381,200.434307850805,174.953786735267
"5741",487,87,400,186.81146307054,182.800313732151
"5742",484,86,398,191.364379111479,180.2019461596
"5743",486,84,402,190.377128060391,177.67643192121
"5744",475,85,390,194.770811764796,177.780578666809
"5745",469,89,380,199.649942376205,173.489311156835
"5746",488,90,398,197.799704369683,173.985412013438
"5747",476,79,397,198.54003324777,181.157073083624
"5748",488,85,403,200.189298724947,181.037047355371
"5749",483,87,396,194.027826314954,181.749449975654
"5750",493,81,412,201.44317875183,176.279131774069
"5751",466,83,383,202.459087120038,177.682134127569
"5752",494,83,411,211.032783327278,174.728198479368
"5753",488,91,397,185.810545141514,176.630877567784
"5754",480,89,391,204.157226515205,181.714083285512
"5755",479,81,398,196.307603927814,179.516681300093
"5756",475,87,388,206.811704350581,178.014637681875
"5757",477,82,395,188.662329644615,179.189640169584
"5758",488,92,396,197.568976235682,178.306090990869
"5759",485,87,398,184.957792660095,176.083606663215
"5760",482,86,396,200.899730810977,176.978067846401
"5761",488,91,397,196.588391280842,177.891655793591
"5762",483,92,391,197.87893926425,176.080549833486
"5763",496,81,415,189.580584987414,177.355744621815
"5764",485,94,391,191.435297531953,178.135461338399
"5765",490,85,405,201.731656006198,178.341096559124
"5766",492,93,399,190.403109078543,181.037171942548
"5767",486,91,395,183.394047007154,177.617729646867
"5768",485,89,396,200.008122381394,181.735909682573
"5769",501,89,412,185.671581436192,172.982098567685
"5770",486,85,401,190.877809839997,175.775517980232
"5771",488,92,396,189.440908316179,173.535204509506
"5772",469,79,390,195.195460705043,174.435770850405
"5773",485,92,393,188.205672786436,179.92197487416
"5774",494,90,404,189.781301715427,167.535675981543
"5775",476,80,396,203.418270110289,177.736891101123
"5776",469,76,393,197.797051211642,179.054433720931
"5777",482,81,401,209.199943158471,181.376631366683
"5778",485,89,396,194.20429775695,175.380645799014
"5779",485,81,404,198.342636710634,176.681463356381
"5780",480,92,388,180.983369200725,178.969285270655
"5781",476,84,392,193.379279086107,179.791687318798
"5782",482,88,394,189.820089749922,176.89154274861
"5783",495,88,407,190.876680472775,177.355079626389
"5784",483,86,397,193.021294891226,177.106876587233
"5785",474,84,390,188.246259007842,177.228829112927
"5786",480,90,390,200.919602965833,174.656847912208
"5787",469,81,388,193.338745912716,179.292418233167
"5788",490,90,400,201.646898264792,174.934644241073
"5789",482,86,396,211.028362751784,171.464419529339
"5790",504,86,418,188.865029080662,176.487588752939
"5791",489,90,399,197.504303701153,174.507220379678
"5792",491,88,403,207.68188695123,174.461225197404
"5793",488,86,402,196.110080387489,175.767535153274
"5794",489,81,408,201.776161276376,173.348742326694
"5795",482,89,393,197.480994945084,175.090794005225
"5796",495,88,407,196.285045350345,178.074440658743
"5797",488,77,411,196.269139266093,176.890960569731
"5798",493,89,404,178.963420008415,181.364628748626
"5799",498,98,400,207.712455998278,176.575307590651
"5800",475,87,388,198.570270439877,177.431173839797
"5801",496,93,403,190.365603252132,171.696869813849
"5802",505,87,418,201.580907165553,179.583245398573
"5803",480,82,398,186.189159580929,174.887807874251
"5804",478,85,393,198.159545594418,171.834601482782
"5805",481,88,393,196.372941792055,176.620212007246
"5806",488,78,410,197.983518328515,174.695713287766
"5807",478,83,395,195.127292901359,175.781640242814
"5808",482,79,403,187.659176836938,167.304161164612
"5809",481,90,391,195.850752783461,176.740467605074
"5810",470,71,399,182.177409382252,179.616381501123
"5811",493,92,401,197.590020319585,173.531520676374
"5812",481,76,405,187.978392996921,178.936910009299
"5813",500,97,403,196.777817605065,178.460726334919
"5814",485,81,404,185.13206490136,174.875501731656
"5815",469,82,387,206.318270140947,181.961451504543
"5816",475,83,392,199.420674854144,175.345115557006
"5817",490,82,408,185.542631021266,177.180445165522
"5818",488,89,399,205.743377938517,181.118523073681
"5819",507,88,419,191.893369396499,179.558807422325
"5820",485,80,405,201.623916132116,173.946725774037
"5821",495,87,408,198.287892649928,179.251319608581
"5822",489,87,402,187.428494386632,176.071880079458
"5823",480,81,399,198.991649302614,169.478684101865
"5824",493,97,396,199.519242595291,181.519514109629
"5825",472,75,397,198.997322236002,176.558739251542
"5826",465,82,383,188.082978957493,183.068629888949
"5827",477,87,390,188.373886009271,180.907509912513
"5828",496,84,412,191.036845530124,170.12747862639
"5829",480,84,396,205.014997313646,177.390505812354
"5830",501,89,412,188.881393288688,176.351523462439
"5831",480,78,402,193.448230021836,175.756651059896
"5832",486,88,398,197.960442569357,180.08377172682
"5833",464,76,388,190.651832289622,179.38353835073
"5834",476,89,387,195.735087636626,175.508010891555
"5835",475,80,395,194.484806067895,179.569817659517
"5836",490,86,404,194.795396252745,174.406517079673
"5837",489,86,403,188.820244947327,175.863355385466
"5838",485,83,402,189.70438129874,181.694729856033
"5839",491,85,406,187.858076156836,177.825633126842
"5840",497,86,411,200.930048877258,179.287950326943
"5841",491,82,409,189.24116807851,175.512962997891
"5842",483,88,395,213.623994622069,173.298282522616
"5843",481,83,398,213.038547537472,174.55064346767
"5844",482,79,403,198.566329145085,179.740128920978
"5845",473,82,391,190.312266491014,179.808769529226
"5846",484,91,393,192.408863487104,179.412843892064
"5847",480,78,402,217.707276944416,178.162840063437
"5848",489,80,409,191.510156181166,181.667524375851
"5849",477,76,401,194.107306859427,176.036345205215
"5850",489,90,399,174.931704643348,177.225062620573
"5851",499,86,413,192.221972625011,174.177531326324
"5852",488,88,400,194.238464325328,175.788194033505
"5853",495,87,408,188.403101701349,182.30306881447
"5854",491,84,407,198.067541374024,169.766243376644
"5855",485,81,404,205.904545219251,172.029195448136
"5856",485,87,398,187.285943929671,171.787418180344
"5857",505,96,409,188.776978496967,176.36451285316
"5858",495,81,414,197.900765854778,175.792585072213
"5859",484,76,408,203.774331520374,180.327802932004
"5860",494,90,404,169.643445042079,179.63884358484
"5861",478,82,396,205.546257473617,173.378577058028
"5862",490,91,399,198.489954723389,179.20215521847
"5863",471,76,395,194.67560503406,173.908579473888
"5864",486,85,401,201.706848146204,174.783291712667
"5865",480,87,393,200.30688847568,170.829931350168
"5866",481,87,394,194.108126590419,170.442411667766
"5867",473,81,392,204.673340004936,177.34446648289
"5868",480,88,392,179.981059086571,176.788263275834
"5869",478,80,398,199.685948021651,172.229972240853
"5870",486,87,399,189.263243791221,177.989601636139
"5871",494,83,411,196.239879603648,178.369184648096
"5872",477,85,392,176.685586709771,175.180701793774
"5873",498,94,404,190.330572155178,182.557125362954
"5874",487,91,396,196.861021229006,171.908330383172
"5875",474,85,389,193.276963993484,178.536625488375
"5876",480,78,402,195.885349475842,172.980535940513
"5877",487,78,409,205.888694821323,171.534977339465
"5878",486,86,400,179.272992327833,177.750646863065
"5879",479,85,394,188.49840403237,177.901079993486
"5880",479,79,400,197.528383255286,171.408559235353
"5881",485,88,397,196.245332942414,167.959196655565
"5882",479,90,389,197.187847929398,174.81614400629
"5883",498,87,411,198.963224441923,178.470985083836
"5884",470,75,395,183.224125026288,178.352732420697
"5885",499,83,416,189.93091083025,173.160567457463
"5886",490,85,405,201.945703732637,176.509707829972
"5887",480,94,386,192.838202477022,179.138141953277
"5888",482,87,395,198.759832272585,180.25912524707
"5889",482,88,394,184.89626513524,182.682677432082
"5890",467,79,388,197.819083883281,180.523793703695
"5891",491,77,414,200.583904965628,177.730548137644
"5892",482,77,405,203.020173384113,172.342290470178
"5893",478,77,401,202.534974517348,176.111436073473
"5894",465,78,387,205.577565229263,178.946726630475
"5895",487,95,392,208.855765738436,173.577258223896
"5896",477,76,401,199.028412852091,176.727832947555
"5897",483,82,401,186.601119278426,172.672998097699
"5898",494,93,401,190.479380008422,170.640606296948
"5899",493,84,409,200.479118791141,171.608393791208
"5900",486,80,406,190.906960463765,177.994433571285
"5901",488,80,408,193.080449484463,176.41337542556
"5902",498,88,410,185.312312577653,176.842991745362
"5903",497,88,409,201.844381980242,177.282130990631
"5904",483,89,394,192.148379880781,177.660846029015
"5905",503,88,415,184.49850056178,174.572069009578
"5906",487,87,400,190.096742105233,175.275852448898
"5907",489,87,402,182.01198060724,176.771790712737
"5908",487,80,407,195.998957428201,168.226934722272
"5909",486,82,404,199.066228589389,175.428589967152
"5910",494,81,413,188.832660043874,173.069103879565
"5911",480,86,394,198.357602312933,175.394143140566
"5912",490,89,401,199.060317012699,176.443447305048
"5913",484,76,408,188.824806569763,180.905751896316
"5914",489,87,402,197.658997851352,185.723539354384
"5915",488,85,403,199.286519145976,172.354564591234
"5916",485,81,404,183.591996455111,173.023981239536
"5917",486,79,407,196.414689180138,176.300802649405
"5918",472,80,392,205.161860796974,179.832945841673
"5919",484,90,394,203.302542434721,173.510134537982
"5920",470,77,393,203.195335899772,174.723941230827
"5921",482,83,399,194.385693132108,178.975189966624
"5922",463,82,381,195.904457135071,173.379024319324
"5923",480,84,396,195.775887363852,180.037520737537
"5924",490,85,405,200.545443412071,184.137860739563
"5925",485,89,396,187.302234174145,179.170021266949
"5926",485,92,393,189.314186500697,175.551419767168
"5927",487,82,405,205.649800171045,177.274058784712
"5928",485,88,397,204.579821087292,172.005987986567
"5929",498,90,408,178.25887413535,177.153243009751
"5930",477,81,396,201.033755042717,178.611833384204
"5931",462,77,385,205.507157453888,174.831613248274
"5932",497,95,402,195.104160709252,177.006460056106
"5933",501,92,409,191.234991586902,178.107538850964
"5934",474,89,385,190.541795378352,179.275977173709
"5935",483,87,396,206.260590203507,173.171347866918
"5936",474,82,392,199.49074718608,173.615507940339
"5937",489,79,410,202.002243993295,177.99423457586
"5938",478,82,396,194.881400655612,174.597095861152
"5939",482,79,403,190.611966627675,173.704080312248
"5940",457,76,381,197.365584267085,175.450585541641
"5941",460,78,382,202.867356614357,170.358756643617
"5942",502,85,417,192.15070133423,175.719097055392
"5943",481,83,398,201.690772435884,176.761726462872
"5944",490,92,398,200.362106347189,172.983313388976
"5945",495,78,417,196.196076280274,175.141537153039
"5946",470,89,381,200.962353669102,168.036212091314
"5947",490,83,407,187.959187715084,176.392434449562
"5948",488,90,398,191.421231217496,182.405347325302
"5949",478,84,394,203.49621515406,180.190103867862
"5950",484,89,395,192.828829133078,173.772187640212
"5951",491,88,403,187.893835275313,177.753692445833
"5952",475,84,391,190.615413000308,178.121323333697
"5953",479,95,384,193.398483557129,179.708378492256
"5954",474,87,387,199.299303215513,173.501412091462
"5955",498,87,411,188.175949867258,175.685658398112
"5956",491,85,406,197.677678582434,177.076321513739
"5957",482,81,401,193.245572600115,169.781158335476
"5958",467,73,394,195.525942060919,178.099501649816
"5959",489,87,402,202.348106790353,180.496883046312
"5960",482,83,399,203.21312204875,169.77413553371
"5961",487,83,404,194.173316854218,176.563246825602
"5962",490,86,404,206.48722534754,171.128065092758
"5963",470,90,380,195.291140068724,171.946460122252
"5964",480,90,390,187.017027868043,175.299790222915
"5965",501,89,412,191.766439701381,177.933200207367
"5966",480,81,399,199.114720199328,181.453441448492
"5967",506,88,418,189.558320576274,175.768301417048
"5968",491,87,404,195.956613098328,180.940915832012
"5969",499,88,411,183.696821731332,177.926759166152
"5970",490,91,399,198.502381222017,177.049526364722
"5971",504,89,415,192.358563813394,170.095156326119
"5972",478,90,388,184.59432191912,182.751560832008
"5973",468,86,382,182.262150652311,172.938754625258
"5974",490,84,406,197.09826307727,180.533351177212
"5975",490,90,400,186.974216954874,174.243909069577
"5976",474,82,392,195.005399724509,174.57456322562
"5977",477,82,395,193.111831616796,179.597715160221
"5978",480,85,395,205.352057778847,170.634272980254
"5979",487,90,397,210.099053411126,169.017950158249
"5980",496,91,405,200.836912376384,174.954027261474
"5981",477,87,390,189.014933129734,179.738816185899
"5982",495,93,402,181.825129219898,182.085292480668
"5983",481,94,387,193.882137795943,179.116708486776
"5984",487,95,392,186.997200651156,178.942408262477
"5985",498,89,409,193.493567371406,169.780821602998
"5986",469,81,388,189.243192757585,181.743066914953
"5987",471,77,394,195.918484387497,166.138879915351
"5988",481,82,399,195.467129746619,181.938122919943
"5989",470,87,383,199.31578590478,176.582575200192
"5990",465,82,383,205.925693874723,179.436042625278
"5991",489,82,407,195.242273894846,175.050747698093
"5992",484,97,387,202.93962999877,176.976626102753
"5993",471,86,385,185.298630702983,173.287577428337
"5994",496,83,413,201.964550428565,176.229828352751
"5995",493,83,410,200.46720883902,181.719960204487
"5996",491,84,407,192.581481521404,172.498951767785
"5997",478,81,397,192.731532793366,171.339218433072
"5998",488,78,410,197.57482805202,176.6072643535
"5999",486,91,395,199.593469554366,180.745056198392
"6000",482,88,394,194.277126974632,173.01675835582
"6001",453,80,373,185.439089248026,179.578522618604
"6002",489,91,398,187.929452256706,176.397543030831
"6003",481,87,394,195.610469608613,174.551544944256
"6004",483,91,392,190.538021807777,174.466801355522
"6005",477,79,398,194.26949571042,168.973524885047
"6006",479,82,397,169.004413329611,171.560169282855
"6007",485,82,403,192.702646043299,176.675873131246
"6008",470,83,387,198.571227327211,172.999596926346
"6009",474,91,383,191.266562355299,177.497760394438
"6010",467,80,387,200.398215012831,177.418323797362
"6011",468,89,379,191.864943853921,178.999578507449
"6012",482,83,399,191.143035895044,175.889369443675
"6013",471,83,388,196.079078321267,182.124463980664
"6014",493,86,407,199.07629115943,179.276821862238
"6015",482,83,399,213.432449268559,178.033656885899
"6016",488,84,404,183.756558709158,176.726155035344
"6017",499,85,414,191.681423261865,179.195602764176
"6018",494,83,411,197.96079217326,176.282159635876
"6019",485,94,391,192.308290214553,175.134163150568
"6020",490,92,398,198.292071493579,174.071768093858
"6021",485,85,400,185.002570358029,175.055677907736
"6022",462,75,387,205.557349323876,177.076746592846
"6023",492,87,405,197.060510000359,173.048122219032
"6024",500,87,413,176.394691526787,174.386906519432
"6025",479,85,394,200.667989623766,175.903707405237
"6026",477,76,401,197.185198051573,179.188903405103
"6027",492,86,406,194.322742056648,181.124826878772
"6028",498,81,417,209.582521695651,177.399795798717
"6029",484,80,404,206.656010378647,176.038749400386
"6030",486,86,400,199.067078407749,179.517892736589
"6031",494,85,409,196.872196775948,177.646565937229
"6032",466,82,384,193.428149910464,179.94670890222
"6033",477,77,400,204.486489643372,175.27203806094
"6034",482,79,403,201.530246077018,180.573290728901
"6035",485,81,404,204.393455866238,176.505917229648
"6036",489,84,405,192.812386126449,174.693321893586
"6037",480,82,398,193.806229074944,180.201683191645
"6038",491,88,403,185.45564620871,181.169191655844
"6039",489,86,403,204.758906809607,178.689703934439
"6040",477,87,390,200.535045882495,177.618589220475
"6041",473,91,382,188.186591747582,178.284717083362
"6042",492,81,411,191.411847022576,179.248400661296
"6043",492,88,404,187.765798038247,173.360007132274
"6044",469,83,386,178.443575915843,175.564669019695
"6045",481,85,396,182.066126588874,181.232697040763
"6046",485,84,401,192.04178387145,176.0772749457
"6047",484,84,400,179.810424873248,175.489333512239
"6048",491,84,407,199.30434039336,176.059002809835
"6049",499,93,406,182.574614418039,177.741812995946
"6050",492,82,410,193.376381321454,177.804812491314
"6051",474,80,394,197.994050561062,175.690824505791
"6052",514,93,421,175.362994066329,182.615814761329
"6053",475,86,389,195.077822911778,182.852888635654
"6054",464,84,380,194.678804903339,176.505747631889
"6055",492,81,411,199.113488047496,176.282064281585
"6056",489,90,399,182.966206136688,171.358623111292
"6057",498,94,404,196.768859634183,178.373942936542
"6058",479,84,395,206.561225953868,179.130035421622
"6059",495,92,403,184.990002447265,177.030711598038
"6060",475,77,398,196.882510500648,179.368469150836
"6061",481,87,394,193.388839486064,174.651024717125
"6062",473,77,396,195.487993432718,177.235033605955
"6063",485,86,399,196.572623390523,170.250659659125
"6064",507,88,419,188.423004373091,173.39564395749
"6065",491,84,407,201.804378950382,175.719909126855
"6066",483,80,403,188.994793372225,177.770820760455
"6067",480,90,390,185.66511515006,176.862073610464
"6068",477,82,395,193.525150108761,170.495192268387
"6069",485,90,395,197.225180630875,173.10055757668
"6070",473,89,384,188.004692279867,179.00512844764
"6071",502,89,413,196.26966197083,178.919182842842
"6072",491,86,405,206.627978831037,171.533620843108
"6073",483,87,396,190.28803878628,178.244407167086
"6074",468,81,387,192.221747843749,177.4718704828
"6075",486,85,401,195.036935378892,174.411520183483
"6076",480,82,398,195.678477240593,175.419149966666
"6077",472,87,385,203.549951651482,176.768672180418
"6078",504,93,411,199.729090926182,174.302468924719
"6079",496,87,409,184.729665321277,182.658285343384
"6080",463,83,380,189.627823418238,182.838040661133
"6081",486,83,403,196.968177300315,173.362930885229
"6082",496,95,401,192.431691084337,177.009467199909
"6083",483,85,398,203.848438920047,176.766139508556
"6084",491,87,404,185.513997339136,167.783190113691
"6085",490,92,398,204.108257815497,177.670233953512
"6086",507,87,420,196.209198917701,181.373497478335
"6087",479,85,394,185.879521584431,173.089539890945
"6088",469,84,385,201.550921448758,175.971813736273
"6089",466,82,384,203.760374826023,177.931690168593
"6090",482,90,392,189.141032742244,177.726389191356
"6091",494,89,405,193.074155021024,178.241911430723
"6092",477,91,386,211.554058072198,175.691142152201
"6093",483,82,401,196.377773972342,182.272954596081
"6094",466,80,386,206.899354708985,177.120285502397
"6095",483,82,401,191.613266741243,179.663288202557
"6096",488,85,403,194.010699820748,172.802785510296
"6097",484,89,395,186.764104586096,167.629289533476
"6098",499,85,414,178.916803133767,173.145360662705
"6099",483,88,395,186.097655316171,177.325450450854
"6100",482,85,397,203.725457694001,179.256127072929
"6101",479,83,396,179.445388845002,178.743941044242
"6102",494,94,400,190.934685428221,179.472556897865
"6103",499,89,410,191.427107079711,178.59741455003
"6104",486,93,393,197.902219053416,177.540400150655
"6105",492,80,412,187.039612745716,177.51002201147
"6106",478,83,395,199.147351727825,181.177343072442
"6107",489,84,405,187.292638445974,174.71123033116
"6108",481,80,401,210.033245221943,173.498739528399
"6109",481,87,394,187.107880139767,178.760666457494
"6110",481,83,398,194.532588983039,184.629163725449
"6111",480,80,400,194.281094750445,178.796668846269
"6112",503,89,414,191.480554674268,177.197288376539
"6113",488,85,403,192.281079107445,181.208470370265
"6114",486,78,408,184.536556519212,172.870565979548
"6115",480,84,396,213.866869538483,181.441530001628
"6116",474,80,394,202.347861422894,177.192480473104
"6117",491,87,404,211.090284159757,179.269109591714
"6118",480,84,396,216.20343750574,175.064807435369
"6119",482,82,400,190.094648039056,181.530123399904
"6120",490,91,399,193.862873452071,171.471607827847
"6121",478,80,398,183.865957293466,178.950587364606
"6122",486,87,399,194.310699627457,178.912741731369
"6123",477,84,393,200.543312906706,179.133350661797
"6124",479,83,396,198.074713852368,176.448459313444
"6125",475,85,390,198.643537461552,183.379972874795
"6126",495,83,412,191.18723772028,182.153333508048
"6127",489,87,402,189.496645723046,178.308884060048
"6128",477,84,393,202.66854377931,182.959630343456
"6129",488,84,404,205.6243712266,176.312434983636
"6130",470,82,388,189.128030049757,177.015438637315
"6131",490,85,405,194.976143542759,172.60690660651
"6132",481,82,399,189.06623561586,179.229885371689
"6133",495,80,415,198.991467558297,176.15087823734
"6134",470,86,384,194.802467753822,172.60243328329
"6135",483,91,392,184.102976169034,174.252900098165
"6136",483,79,404,194.276265167966,175.427894989488
"6137",496,87,409,201.94710848721,182.579504027092
"6138",490,83,407,200.522794772748,179.001732468455
"6139",490,84,406,195.664356339072,181.245867517184
"6140",494,88,406,192.925992675572,176.690862072141
"6141",488,87,401,201.057379625367,178.005023034243
"6142",470,87,383,187.420907894881,173.432742825612
"6143",482,82,400,178.473121838305,176.894868189816
"6144",485,85,400,205.028914671455,176.296672910678
"6145",486,87,399,200.040702295957,178.963994531963
"6146",480,86,394,199.349034375292,177.936938188818
"6147",478,89,389,204.543328601919,175.108552089375
"6148",487,84,403,206.439820337955,178.324863973441
"6149",481,86,395,200.884425353823,175.007358401149
"6150",491,87,404,204.983768257236,178.404266128156
"6151",495,95,400,200.322474765088,173.409181375812
"6152",463,79,384,188.849790155997,177.235132990589
"6153",481,83,398,184.538004467664,180.613330513008
"6154",492,81,411,193.1056879166,175.440654046852
"6155",504,93,411,201.325507686607,175.636365546815
"6156",486,88,398,196.150410953422,178.307986425007
"6157",492,88,404,185.670688929253,181.573046823356
"6158",477,84,393,185.59220036341,174.472838499552
"6159",503,95,408,199.689879098255,176.912715819151
"6160",490,82,408,192.091280201046,180.657519894935
"6161",490,86,404,194.294063683235,175.638669073261
"6162",490,95,395,174.476190415668,175.833397768327
"6163",474,79,395,188.07729319716,170.572305164804
"6164",504,90,414,189.234677739768,180.783517337425
"6165",483,82,401,183.004483897697,170.48660024605
"6166",493,87,406,178.39015021871,169.835477975322
"6167",481,86,395,184.113249670571,180.403847622324
"6168",473,84,389,210.998213393,179.405319384215
"6169",501,88,413,202.031487020396,174.29396537432
"6170",485,82,403,195.109545860975,175.005706896904
"6171",503,89,414,184.514875062086,179.910413381656
"6172",484,85,399,196.888503093822,179.269667871982
"6173",476,86,390,195.286165043749,180.602754518262
"6174",487,90,397,201.272742368282,179.873628682175
"6175",477,81,396,185.653811117422,175.548920461673
"6176",480,84,396,188.849920677774,177.151433906679
"6177",467,86,381,179.387700234963,177.490036323162
"6178",473,91,382,188.945641319956,169.648517284585
"6179",485,90,395,193.515417294681,174.284710421631
"6180",484,96,388,200.858292983329,179.93493688569
"6181",483,85,398,187.272779447165,170.930630070247
"6182",480,86,394,208.25848452812,178.568719917816
"6183",489,90,399,204.316584704949,176.9745191961
"6184",472,84,388,190.542050434293,176.752900284103
"6185",471,78,393,207.051791497769,182.477402884906
"6186",478,88,390,182.672113912426,175.084856512344
"6187",480,87,393,178.063630995934,173.954122551971
"6188",483,85,398,184.508131417252,173.706698923981
"6189",471,83,388,180.112948570517,182.413028306529
"6190",480,84,396,202.986143768513,176.463952580801
"6191",486,81,405,193.810051780934,176.329323022191
"6192",492,84,408,176.788387732965,176.5839836009
"6193",485,90,395,173.141771674655,173.157510033191
"6194",464,86,378,185.212581994817,182.69341196439
"6195",504,94,410,187.980749640724,173.956176756841
"6196",473,85,388,186.418549629994,176.019080541149
"6197",481,85,396,189.749232597421,180.561418912427
"6198",479,83,396,179.084048497204,170.180891365996
"6199",482,84,398,194.830453166545,177.945852595973
"6200",489,90,399,195.276028381187,179.747942323742
"6201",500,84,416,203.768369772218,177.181460493132
"6202",489,89,400,188.711700203133,179.365600957251
"6203",492,84,408,212.26777091281,170.631542433388
"6204",477,78,399,214.824235494601,176.311877437109
"6205",488,81,407,189.821221977296,177.469134317656
"6206",484,78,406,197.450145365468,179.149990163002
"6207",497,84,413,213.184131533381,173.066142001132
"6208",483,93,390,201.935232972898,175.845699643647
"6209",480,92,388,198.518885389355,174.198037798213
"6210",475,82,393,186.209743908666,179.08149127092
"6211",467,78,389,198.531035889522,174.823168793754
"6212",488,87,401,197.958199634527,176.717312596933
"6213",480,86,394,189.361133104741,178.494584550644
"6214",476,88,388,202.018857085035,178.92142891795
"6215",470,86,384,191.849598978205,174.407155814532
"6216",489,90,399,190.3716682326,177.12514881524
"6217",475,80,395,190.451499317163,170.62321331501
"6218",480,82,398,198.985327292343,174.061791815243
"6219",485,84,401,195.641948787807,169.436118373527
"6220",473,86,387,185.687069773199,171.227180631195
"6221",474,89,385,191.344965714852,174.242776095928
"6222",480,82,398,201.834990688035,179.817619297069
"6223",482,90,392,197.36153579217,179.738574329685
"6224",490,92,398,212.927121128215,174.394180904344
"6225",475,80,395,202.196782884124,177.719859233872
"6226",475,87,388,197.066084818415,178.45339480442
"6227",474,83,391,202.132048890539,175.74091728421
"6228",476,83,393,191.515071521938,178.60888533073
"6229",505,91,414,198.501889593197,170.267108136928
"6230",487,80,407,195.862577571249,173.829057901402
"6231",481,85,396,204.683021314807,181.553005942332
"6232",461,77,384,195.066875463552,170.096401708309
"6233",477,90,387,195.376799401148,182.604929152787
"6234",485,87,398,201.575276412747,174.704831500164
"6235",500,84,416,190.057988098818,177.16619325318
"6236",485,76,409,194.082394371105,178.598522111005
"6237",472,91,381,198.768663439657,175.278472557027
"6238",496,82,414,192.712215264393,171.771552105716
"6239",474,81,393,195.901098326944,175.58840409905
"6240",487,83,404,192.250387900852,174.121441400203
"6241",476,82,394,204.505289573136,173.025905679749
"6242",488,89,399,201.414262988985,173.630439611706
"6243",460,80,380,196.77637363765,178.472168026465
"6244",486,81,405,196.122493775031,179.547638227571
"6245",483,79,404,183.629067216916,177.503206093861
"6246",481,86,395,199.95480036372,180.888960037554
"6247",487,88,399,191.981547328484,177.216187676468
"6248",474,79,395,190.932968999157,170.512982102503
"6249",488,91,397,190.066543777941,180.533545000803
"6250",494,82,412,205.147846825767,173.672545889965
"6251",482,88,394,187.846029894001,174.289661367061
"6252",497,80,417,198.313633183369,184.186088853077
"6253",485,87,398,196.630995185262,173.349109105502
"6254",489,91,398,194.329600393234,174.221522655627
"6255",483,83,400,199.423892463308,181.222019380964
"6256",476,93,383,198.287475684377,175.121377103239
"6257",469,85,384,202.929677099391,170.025131232842
"6258",487,90,397,201.055989958882,173.514425983487
"6259",507,92,415,192.214162439119,178.533359416302
"6260",508,92,416,192.558650414203,183.869086085548
"6261",490,86,404,193.066970758107,170.421146310819
"6262",489,79,410,194.155768963191,183.721586194271
"6263",499,89,410,206.604980389842,182.325705438348
"6264",496,97,399,194.27967585259,176.876009370757
"6265",498,87,411,192.182775492513,168.526397466382
"6266",492,83,409,196.723768815559,178.72180902722
"6267",489,79,410,180.352740301889,176.720644658012
"6268",488,76,412,207.285661348866,176.193452874017
"6269",488,91,397,195.537439495938,171.028698410986
"6270",484,92,392,211.063595055521,182.55689949735
"6271",488,86,402,194.831958471256,176.224756857151
"6272",496,79,417,181.100736229615,183.66661234132
"6273",494,96,398,193.761627882032,174.432238220375
"6274",489,91,398,188.895240705317,173.960140327014
"6275",471,82,389,185.29013942587,172.720279702515
"6276",467,81,386,191.18027667873,180.581161797414
"6277",473,84,389,202.748722584757,178.711328164556
"6278",464,85,379,205.125560671926,178.866386598805
"6279",485,85,400,195.850201287231,178.948305352405
"6280",471,81,390,200.087872595451,175.070541056366
"6281",487,91,396,199.598837055349,178.570148775003
"6282",482,82,400,201.528848874852,175.371679478319
"6283",489,85,404,205.49854101482,171.382096974483
"6284",480,79,401,204.963823175906,176.079788276309
"6285",475,83,392,203.297311572179,175.607831807139
"6286",477,87,390,200.560145109093,173.453358409593
"6287",469,83,386,200.630655669214,182.633675982186
"6288",496,90,406,191.902436545316,179.37844433703
"6289",506,88,418,196.120952876166,174.201716219744
"6290",489,79,410,196.041804744851,181.885343205743
"6291",485,93,392,193.516320291239,172.095111299055
"6292",485,92,393,192.26951169695,174.959857694495
"6293",481,78,403,191.592014737968,175.947082550395
"6294",479,88,391,205.41027209488,178.203510208347
"6295",472,89,383,191.945627482357,167.723832397278
"6296",492,87,405,200.986873888781,173.333200380784
"6297",475,94,381,193.940963020715,177.756753289618
"6298",473,85,388,204.509973739523,178.656919139998
"6299",471,93,378,203.190957961051,171.342241242891
"6300",502,102,400,171.384015209603,176.792986512983
"6301",492,90,402,191.147995855909,176.158627242541
"6302",460,82,378,191.435882038469,178.121444910989
"6303",486,83,403,183.237536157512,182.806208395217
"6304",484,87,397,200.11500511981,180.540922097051
"6305",478,87,391,203.048647380957,179.607130634681
"6306",491,100,391,205.266201367379,176.714586335537
"6307",486,90,396,202.903071690741,186.297403236803
"6308",511,95,416,177.140315385961,174.088046231164
"6309",488,77,411,195.244987704731,174.690119071017
"6310",486,87,399,199.417121246457,178.842359114574
"6311",482,77,405,192.771426213004,175.648338896537
"6312",484,83,401,192.991982119003,170.677383072179
"6313",482,85,397,191.87233499933,179.36775809698
"6314",483,81,402,189.896315678816,182.759236495619
"6315",471,79,392,185.849405003457,177.64455268526
"6316",489,87,402,193.691461685544,176.217818071113
"6317",494,87,407,197.894707468847,181.004060254411
"6318",507,90,417,202.28035664611,175.873645122678
"6319",502,83,419,193.231224387002,179.205577391192
"6320",484,88,396,193.238074327009,182.104004863058
"6321",484,85,399,215.320535119088,174.153483688986
"6322",475,79,396,190.025435871525,183.31117292559
"6323",483,84,399,201.797139789627,178.478907782692
"6324",465,78,387,201.11471019415,180.070465708575
"6325",488,92,396,199.594014558987,179.267953281729
"6326",485,86,399,191.252714424772,181.52149101581
"6327",477,85,392,194.352608810076,172.396838235982
"6328",477,94,383,199.596344420716,182.783346409317
"6329",491,86,405,187.656121398297,179.470200705977
"6330",479,78,401,203.31844193984,175.412209738076
"6331",482,85,397,200.120648246525,179.057910761313
"6332",494,83,411,206.040541301055,170.617218929135
"6333",481,80,401,200.744742714678,171.062927672997
"6334",480,84,396,190.73479175442,176.64461865856
"6335",492,88,404,186.258669267111,177.753728183399
"6336",490,82,408,195.378127900266,175.355946990817
"6337",491,88,403,193.755691416029,171.514734448617
"6338",492,85,407,184.386700289556,180.107470704758
"6339",474,87,387,192.96241202772,177.21044861336
"6340",492,95,397,189.170607629123,178.963394732446
"6341",480,81,399,207.9221111241,175.577445234797
"6342",494,88,406,199.005594315942,174.571053572068
"6343",499,89,410,190.720156196786,173.332832966567
"6344",497,84,413,183.460957287716,181.730145052235
"6345",479,89,390,201.281089557073,177.047608129887
"6346",494,87,407,199.17927022916,179.623813196902
"6347",491,89,402,195.020545423093,174.111335000616
"6348",479,81,398,205.863735544157,179.041272647126
"6349",500,87,413,190.738044228987,176.023328987037
"6350",467,79,388,191.756185456568,176.379657892465
"6351",471,81,390,206.128036542675,173.831894391893
"6352",497,85,412,202.921351389509,182.033637848259
"6353",457,81,376,203.624264875565,176.695029024054
"6354",492,78,414,199.955122938406,185.286430271122
"6355",487,79,408,198.953040306281,176.444906113655
"6356",490,84,406,196.108048833289,173.372404657351
"6357",493,84,409,194.605431532032,178.39020380829
"6358",488,90,398,187.997715936053,182.806217295668
"6359",489,83,406,195.145528245826,173.655442851596
"6360",473,85,388,186.081120743318,179.01278037424
"6361",489,88,401,204.799679474279,181.933544178267
"6362",488,82,406,193.618011502786,179.863033215081
"6363",483,81,402,203.750985024982,176.758740002229
"6364",472,87,385,179.909007091434,177.308179386454
"6365",478,84,394,195.36806698047,172.097142098672
"6366",469,84,385,189.86410100813,179.411704021721
"6367",493,82,411,186.787277336138,182.410865936896
"6368",489,85,404,178.192744004625,174.325534595668
"6369",488,89,399,192.017219032469,177.010581362805
"6370",493,85,408,186.423898125917,170.646565245669
"6371",491,81,410,205.712994245655,176.635266639259
"6372",460,74,386,210.516623977514,173.135273311519
"6373",482,84,398,198.248512257248,178.981976210887
"6374",486,98,388,197.048412028927,177.889571671699
"6375",483,101,382,190.114856156771,177.594998145308
"6376",483,89,394,201.789352067574,174.999906980995
"6377",490,91,399,214.258967916335,177.793503871371
"6378",478,90,388,187.40714621209,176.973562200309
"6379",481,79,402,202.374716740683,179.71550347615
"6380",497,83,414,190.97511276375,181.007294304172
"6381",482,84,398,194.127277496446,184.600728860365
"6382",499,89,410,196.093155358075,177.210238140062
"6383",471,81,390,186.269896602844,178.864960052494
"6384",488,88,400,194.911625727814,173.490127271732
"6385",474,88,386,205.449011619016,181.387134801241
"6386",479,84,395,189.585074796767,176.889761845253
"6387",483,82,401,193.285274393736,179.479646349404
"6388",493,87,406,206.62028914838,173.647849356642
"6389",490,86,404,211.738230355576,177.739816351293
"6390",486,81,405,197.049916476091,175.833005564345
"6391",475,79,396,200.379289611046,180.540872262148
"6392",483,81,402,197.908280933542,177.68006738781
"6393",481,83,398,193.167732659077,174.77991695043
"6394",507,95,412,184.163510442954,178.247990141431
"6395",499,87,412,186.680211920873,178.879851898098
"6396",484,89,395,201.548122449668,178.869588636641
"6397",483,84,399,199.599438472382,176.694638592448
"6398",466,84,382,202.930665846142,173.519273844564
"6399",507,92,415,194.040877793727,183.766487945046
"6400",494,84,410,202.708055307722,179.276122307771
"6401",481,84,397,207.705080492553,180.86630658109
"6402",482,90,392,203.276171792515,176.204715806325
"6403",470,79,391,203.958858718105,169.356198006281
"6404",490,86,404,194.281668457791,177.378893128509
"6405",488,87,401,191.927185802725,179.641057674325
"6406",490,86,404,209.828745012,179.661206663467
"6407",480,87,393,187.716565615268,173.515855050077
"6408",472,87,385,189.779436223188,176.205436182348
"6409",501,84,417,193.424442549133,176.761888175478
"6410",506,98,408,196.317285000329,179.103193332797
"6411",475,79,396,197.243781901783,175.29924189286
"6412",493,90,403,185.998413927783,184.840507873678
"6413",460,85,375,193.746639971021,180.529440585988
"6414",509,86,423,192.723769894792,177.447904453018
"6415",479,91,388,195.783138383178,176.836457981267
"6416",468,81,387,201.533269293791,178.815774044983
"6417",479,87,392,205.906188305495,181.49634545122
"6418",489,84,405,183.978611123275,179.899712353961
"6419",483,89,394,196.137958670337,176.534222927305
"6420",488,83,405,201.242283345927,178.945595453243
"6421",488,88,400,203.444022696686,173.908393969611
"6422",463,81,382,212.395547758434,183.096160436397
"6423",471,90,381,200.967775087521,174.607654009128
"6424",485,78,407,184.210016168891,181.593876380621
"6425",492,84,408,193.760103371653,179.053457893609
"6426",486,91,395,187.76305110934,176.938610549079
"6427",484,77,407,202.686038651035,178.176936471923
"6428",485,95,390,183.538881361974,180.624130587435
"6429",496,82,414,194.968810718079,179.328304441041
"6430",487,86,401,199.58916817255,174.21818252606
"6431",487,88,399,196.062908801699,175.097064879769
"6432",470,89,381,180.513200741816,184.451644047308
"6433",480,91,389,189.195910080647,169.983323490653
"6434",474,84,390,193.236069424583,173.608935766524
"6435",474,84,390,197.978921799044,170.164348184978
"6436",489,84,405,185.538938751578,175.873886280184
"6437",481,84,397,194.619874996552,173.686493418107
"6438",472,81,391,191.707419771566,173.531215748237
"6439",490,80,410,203.217325177549,178.466514127318
"6440",480,79,401,193.413091128403,174.363441071583
"6441",492,83,409,185.357792932138,173.608684681777
"6442",465,89,376,195.238292503156,173.752171980345
"6443",493,84,409,194.483040020879,172.07649161107
"6444",476,84,392,212.080460095289,181.876963323435
"6445",486,93,393,186.829915912135,180.797944351809
"6446",486,87,399,190.393501409729,171.446021297708
"6447",490,84,406,201.71465745666,171.903044017374
"6448",475,88,387,189.139668221534,179.280929870246
"6449",493,94,399,204.721890171774,178.652480624338
"6450",474,81,393,211.216568168396,182.235857692744
"6451",500,89,411,179.565449914326,180.152263263874
"6452",504,89,415,192.605258443852,177.33488944955
"6453",478,82,396,195.787567572573,176.691645803279
"6454",479,96,383,197.628956907823,173.805595164995
"6455",480,88,392,203.643903516795,180.930937759752
"6456",478,88,390,191.781749836401,179.12747583599
"6457",479,91,388,197.659479902947,185.745790433023
"6458",486,83,403,196.310175073517,176.413164609794
"6459",481,83,398,195.466538600527,177.034648389713
"6460",483,89,394,193.357298150751,178.481388945885
"6461",484,87,397,196.683221709498,175.015185202328
"6462",494,91,403,204.421317111824,176.851184606413
"6463",469,80,389,188.81616168777,173.280055296489
"6464",474,79,395,205.445775013035,176.361348195109
"6465",486,94,392,193.733589152972,177.715828625956
"6466",500,90,410,200.272556721779,177.599909578618
"6467",469,84,385,193.197064516835,183.589505137735
"6468",478,79,399,192.570658515522,175.333361184746
"6469",485,86,399,184.151039269666,171.475690284531
"6470",490,82,408,188.158626424121,177.943625085768
"6471",485,92,393,186.778024610643,174.491633072569
"6472",501,90,411,185.344003728594,175.689184113751
"6473",487,87,400,185.12828423735,171.46224013069
"6474",479,86,393,205.696233520316,179.938114471891
"6475",480,83,397,199.910282439274,179.04195093129
"6476",501,95,406,188.910468097327,176.048238982557
"6477",479,86,393,206.460707140636,181.035318257827
"6478",487,84,403,192.345471989346,177.845226958937
"6479",465,88,377,185.044952769527,182.810103113971
"6480",472,85,387,186.427544655328,180.482252942727
"6481",491,84,407,194.980899119529,177.986917204342
"6482",483,83,400,200.505781602672,178.911024946177
"6483",480,85,395,199.932990728917,171.444018375548
"6484",495,91,404,201.861732775181,175.083494792583
"6485",469,89,380,190.525428210018,177.488071223344
"6486",485,89,396,185.791675153374,176.23365402692
"6487",481,82,399,186.53812793618,174.977036970405
"6488",485,80,405,202.278698545806,168.602771601142
"6489",483,80,403,189.172902203535,173.733227483179
"6490",473,87,386,197.226965011313,177.663032914739
"6491",481,83,398,191.74835988954,174.709019985011
"6492",468,80,388,189.941534200836,175.400290378652
"6493",474,83,391,195.922525838833,173.125930628672
"6494",486,90,396,196.853816071246,173.753712721742
"6495",488,86,402,198.371339600808,178.298628676503
"6496",482,80,402,193.418811103194,173.811149109183
"6497",472,94,378,201.328198768363,177.637072556008
"6498",476,88,388,193.294306157422,182.306186627273
"6499",497,96,401,202.568963145448,170.658445494286
"6500",474,87,387,190.698061060517,176.924765087322
"6501",479,87,392,193.348931641681,176.581181365008
"6502",482,83,399,183.485428205757,175.337553108835
"6503",477,92,385,200.364842212851,179.7833147477
"6504",476,90,386,196.032096876341,178.325434176719
"6505",477,87,390,206.072450903784,179.939414597178
"6506",472,88,384,187.21671968122,178.341482774416
"6507",467,77,390,210.762720443091,180.486262863009
"6508",478,83,395,189.684001370894,183.653342074156
"6509",485,81,404,199.877623271003,174.424255071329
"6510",502,93,409,193.61671596517,180.051303092048
"6511",500,88,412,178.044892341903,179.962843227776
"6512",514,90,424,197.849408796267,173.42036304767
"6513",496,88,408,209.144688785789,173.919044853283
"6514",486,93,393,194.735572044498,175.237746862508
"6515",477,78,399,183.746665877986,173.517849601675
"6516",477,87,390,197.248917160509,172.116855187218
"6517",470,84,386,185.204791163984,181.048079064337
"6518",468,81,387,206.963775490881,179.313352495774
"6519",485,88,397,192.665322398528,174.446927486355
"6520",497,80,417,185.617064263188,172.627330126465
"6521",498,90,408,188.069598041649,180.317273063275
"6522",476,86,390,198.103813429379,173.641421215045
"6523",468,79,389,194.01990448486,175.815200947934
"6524",486,93,393,184.773200592299,177.745926316501
"6525",474,91,383,182.229428097379,175.606154770674
"6526",485,91,394,196.61888430766,176.498755316161
"6527",490,87,403,192.260380972312,180.089660841356
"6528",490,88,402,193.362233240201,173.572027892842
"6529",498,89,409,196.917884286143,172.739063416853
"6530",472,83,389,198.411650348676,172.571884501206
"6531",483,87,396,191.418493759233,177.252243802162
"6532",497,95,402,187.706994978385,179.4661044936
"6533",508,89,419,172.595883319208,184.205419993744
"6534",507,83,424,193.472533426411,180.789242964455
"6535",468,81,387,196.905445026329,176.712756999206
"6536",471,81,390,198.972507724309,181.006695581108
"6537",489,97,392,196.701974922697,181.475296906536
"6538",479,84,395,193.007679641047,177.958241415397
"6539",483,93,390,193.70920885423,178.251769900447
"6540",471,81,390,198.518192269234,175.070450395372
"6541",475,83,392,206.761474489248,177.951443525861
"6542",483,86,397,191.076989564109,168.30277325708
"6543",483,87,396,200.860863669527,172.29671166709
"6544",463,91,372,189.494021264837,183.703127473681
"6545",485,87,398,191.364949694147,176.565875452521
"6546",490,83,407,201.620919434203,177.877585071933
"6547",507,86,421,196.10128539045,177.076322981892
"6548",467,89,378,185.709678513026,179.877339405475
"6549",481,83,398,196.719097441333,176.640499426758
"6550",480,87,393,188.890640900584,172.502457600447
"6551",490,82,408,199.453635411091,174.322357669531
"6552",481,84,397,192.652571534214,174.937108687999
"6553",480,86,394,199.830069157141,178.078930899831
"6554",488,92,396,188.876293752921,177.270403608448
"6555",473,82,391,181.80103558536,176.588077281116
"6556",472,86,386,186.36418317181,178.349313795815
"6557",485,79,406,203.601916185511,184.917592055915
"6558",493,88,405,189.308982662561,177.21613841327
"6559",480,86,394,195.895749426075,180.840214420878
"6560",495,87,408,189.435577460501,171.930504104402
"6561",490,94,396,192.684381881941,179.668437702499
"6562",482,86,396,195.424732450659,177.259232336478
"6563",476,78,398,200.787013860098,171.215186254877
"6564",487,87,400,181.468904004557,179.176083358623
"6565",476,84,392,192.402979859714,174.072386786807
"6566",481,83,398,190.863665305352,180.085222383744
"6567",493,89,404,201.239206474399,172.181045727877
"6568",474,93,381,195.090404044001,180.267669834558
"6569",519,96,423,191.379270710966,175.523518924743
"6570",486,83,403,201.746686613938,173.44121686884
"6571",483,94,389,200.553794102697,173.622874330702
"6572",484,91,393,203.781965762318,175.065178227367
"6573",492,85,407,206.289619337319,183.02640396599
"6574",473,76,397,203.760774380214,179.758645229823
"6575",484,86,398,192.795200427833,176.641794238515
"6576",480,91,389,202.731762702957,181.923411194856
"6577",482,79,403,196.152316279977,182.640746113754
"6578",478,88,390,194.657206897328,170.499629938196
"6579",486,95,391,187.318156232601,176.226820434658
"6580",469,84,385,213.107929517856,171.631591757622
"6581",478,85,393,195.22503940404,178.335857693981
"6582",491,83,408,188.419931844018,178.514866838097
"6583",491,84,407,197.993335668131,174.121849304012
"6584",490,87,403,182.914677240897,176.139731123743
"6585",489,85,404,195.459290603121,170.86340362253
"6586",493,83,410,199.788151168857,179.78399464848
"6587",491,86,405,191.110765627018,173.845475405607
"6588",489,88,401,201.799552589881,177.494022810366
"6589",484,90,394,198.380846625628,178.264687323922
"6590",482,84,398,193.88912344229,173.136840974341
"6591",479,83,396,194.258269512095,182.123800279446
"6592",478,81,397,194.439177499165,174.220786308513
"6593",492,89,403,194.570229739853,173.398309353325
"6594",479,76,403,189.76585852354,178.472018928288
"6595",490,82,408,195.969020256578,177.683768047365
"6596",490,86,404,208.916476614733,173.255395197931
"6597",502,94,408,199.471597173299,176.689370019805
"6598",478,93,385,196.352188202557,181.402078896728
"6599",488,85,403,200.977381691206,178.838170942773
"6600",485,91,394,181.873036932979,170.319798424921
"6601",486,82,404,189.700009122778,171.169027219991
"6602",479,86,393,209.16425323126,178.93553892082
"6603",495,77,418,189.56668895196,173.828040797131
"6604",483,81,402,207.461991722674,174.775282569288
"6605",463,86,377,197.637654532472,174.753237215637
"6606",486,90,396,197.12757489146,173.608531576502
"6607",497,86,411,198.998230377466,174.165007270117
"6608",464,83,381,202.066946502333,178.989806963134
"6609",478,86,392,191.364893343072,179.451620317604
"6610",484,87,397,181.736849068426,174.793948269266
"6611",489,85,404,186.591621227834,184.491179767801
"6612",490,81,409,194.048908920013,174.697461721157
"6613",480,87,393,192.394912320794,170.149575720898
"6614",473,84,389,202.114392026091,176.778973915854
"6615",480,86,394,198.913374161243,167.443984196167
"6616",491,93,398,177.581552715346,176.922918740446
"6617",481,89,392,187.129653765824,173.866983671609
"6618",473,88,385,186.702966572692,180.120362046393
"6619",482,85,397,200.111712514079,172.935255413847
"6620",480,93,387,197.598700483304,178.410399605465
"6621",487,93,394,196.055098817821,178.45225026366
"6622",489,87,402,210.969590033213,171.867871205178
"6623",491,84,407,199.834146883434,177.133813205724
"6624",499,90,409,193.987507595892,184.015949288947
"6625",480,78,402,188.220160943596,182.21464190379
"6626",468,87,381,194.704719513911,177.370522695829
"6627",495,83,412,201.672715048127,175.499692415851
"6628",476,84,392,189.86490453274,178.243046842641
"6629",497,96,401,188.084502502303,171.338732842375
"6630",475,85,390,195.334214978386,179.191810874645
"6631",475,80,395,209.923799720702,175.908903648236
"6632",493,91,402,185.96944752808,177.161400868218
"6633",495,87,408,196.520286418672,173.636216417327
"6634",487,93,394,190.21154394489,176.687914851775
"6635",487,88,399,197.723376269099,172.063858031436
"6636",492,95,397,198.785172271989,175.254683209792
"6637",483,86,397,208.736231014883,180.113213979397
"6638",485,86,399,183.773345866849,181.137493521662
"6639",467,82,385,198.073814735285,173.283444806935
"6640",468,87,381,196.739554430947,178.69666739944
"6641",485,83,402,193.347406985899,183.278505587437
"6642",479,83,396,198.852500306764,178.741336412096
"6643",503,86,417,180.925660941125,179.37835069985
"6644",493,86,407,192.930016613873,174.866198235465
"6645",480,89,391,186.893034799331,178.320247190386
"6646",490,88,402,206.938537598511,179.799874010242
"6647",470,83,387,197.038413277071,180.731887500883
"6648",491,89,402,199.274730288636,173.172494732731
"6649",485,87,398,188.672843596776,172.832093971268
"6650",483,94,389,199.21989834326,175.395546359942
"6651",471,80,391,198.528118375875,169.803229661931
"6652",482,87,395,199.492078427761,180.738249853673
"6653",469,80,389,199.593309915279,176.769943240432
"6654",484,81,403,196.720540559165,176.664627856014
"6655",478,91,387,190.013333819369,171.95054355361
"6656",495,99,396,192.376472908193,171.408336484404
"6657",501,92,409,196.56588473306,170.438454287502
"6658",490,82,408,191.239757963512,180.306115728149
"6659",475,89,386,202.355288478333,176.224105541095
"6660",481,79,402,184.45327445981,170.911407763704
"6661",470,87,383,186.19491351919,176.790380733804
"6662",481,87,394,187.512386344559,180.735808193605
"6663",493,90,403,206.634310829462,171.975248068225
"6664",473,87,386,197.067166798672,175.767162017948
"6665",477,91,386,187.376076624702,176.350091964392
"6666",481,93,388,198.27996178594,173.943234462355
"6667",479,87,392,212.895571559396,182.576962708027
"6668",477,87,390,205.837706450821,172.259068532226
"6669",496,91,405,193.76583350608,175.948418623751
"6670",466,87,379,196.723240024304,176.017306472905
"6671",489,88,401,184.724504796105,176.812155641574
"6672",480,82,398,196.834109466055,177.407937101605
"6673",468,81,387,192.827897219364,173.893368536366
"6674",479,88,391,193.272078582644,174.333192720622
"6675",476,85,391,181.248981260407,181.621910808608
"6676",473,92,381,197.667679241958,174.623596114541
"6677",487,77,410,194.652792142151,171.269669551311
"6678",491,77,414,192.150689577937,174.805848966657
"6679",481,85,396,194.994935300617,178.511428604211
"6680",488,85,403,181.406821155762,175.047095120775
"6681",484,82,402,182.921132828709,181.411442039996
"6682",491,92,399,204.037560170469,172.942191581498
"6683",458,80,378,199.918649788111,178.3620968938
"6684",489,85,404,189.262695256085,179.149046753989
"6685",488,87,401,198.618137538292,180.05942974463
"6686",493,88,405,194.07126475387,177.025292939194
"6687",489,88,401,205.116338105125,175.087837466392
"6688",483,84,399,193.624599773503,176.422047570981
"6689",485,82,403,206.616712853927,175.848743447
"6690",475,91,384,197.895390752935,176.829034631498
"6691",503,94,409,185.65728554863,177.232635428878
"6692",463,77,386,190.62775309237,181.103832439322
"6693",477,88,389,199.74215414534,179.552896418152
"6694",482,89,393,197.339344965539,173.206568424463
"6695",486,89,397,197.67713829279,170.319170299248
"6696",479,86,393,190.575406146016,174.558816255545
"6697",476,86,390,198.663984954733,171.729101064641
"6698",485,90,395,189.546927805241,177.711972593508
"6699",501,88,413,184.696454890043,175.677193855751
"6700",480,86,394,211.146586138317,171.444604689475
"6701",501,88,413,199.965912142165,173.49859352359
"6702",479,85,394,193.439510044286,176.840300202931
"6703",475,89,386,209.981723730526,178.082742362283
"6704",503,80,423,186.640442298266,178.436747634075
"6705",491,85,406,185.245890976855,175.607691160294
"6706",481,80,401,200.399300398362,176.249243575558
"6707",475,75,400,191.150747779411,173.588343998337
"6708",482,85,397,190.541573533363,176.709293297247
"6709",481,88,393,182.969564750946,172.655432024076
"6710",484,86,398,198.885902841565,177.656518478347
"6711",490,92,398,199.046893569989,180.756684251493
"6712",498,86,412,201.93200734305,180.33964741795
"6713",499,94,405,201.626784344363,176.580928338073
"6714",493,85,408,190.49467593512,181.011273855447
"6715",493,92,401,185.36934554643,180.100976729518
"6716",480,89,391,184.716272069538,175.512134518561
"6717",480,89,391,185.536292624452,177.799318569124
"6718",492,89,403,188.209154928848,178.289870429398
"6719",508,96,412,185.259057083363,179.424678163931
"6720",495,81,414,191.287042543481,176.822740295014
"6721",483,85,398,202.207603735775,178.192407199987
"6722",475,84,391,208.099718732404,179.608298121427
"6723",481,81,400,195.736269754825,177.289743800207
"6724",484,88,396,199.830089643269,180.598322562428
"6725",472,86,386,200.975444454873,172.696122479883
"6726",485,84,401,207.901329381521,178.324703271867
"6727",476,81,395,196.514089935276,177.026107522127
"6728",468,83,385,194.460564358993,174.198951910003
"6729",491,91,400,197.327364675145,173.290157128457
"6730",487,88,399,197.018632376428,176.506197543684
"6731",457,72,385,192.640739206131,172.430123498434
"6732",484,81,403,203.072869239188,181.493444084039
"6733",462,78,384,192.360138232252,175.083215115419
"6734",479,78,401,188.912867521491,180.179015455759
"6735",484,92,392,180.457066040644,179.168305927506
"6736",480,90,390,194.82984636195,179.21569065731
"6737",484,91,393,198.003250935239,170.566558668931
"6738",471,81,390,195.841703079904,168.654963111427
"6739",490,85,405,202.113622022774,175.215280108909
"6740",475,83,392,197.139010310744,183.788341170118
"6741",501,91,410,179.159262693922,176.117029797623
"6742",476,82,394,191.067050644363,178.375370422812
"6743",492,84,408,180.00432221284,176.482669524909
"6744",489,88,401,192.050324280769,173.03920333608
"6745",489,87,402,192.468181481345,178.998658943572
"6746",487,92,395,193.980501215264,178.616871589481
"6747",493,85,408,196.497021236579,176.139467145383
"6748",494,86,408,196.434135041818,179.652096998303
"6749",489,78,411,193.303135965535,176.346630534047
"6750",474,83,391,207.096869732485,176.724191166088
"6751",497,86,411,198.011965860351,171.483354854327
"6752",490,85,405,201.042954813762,175.999427675451
"6753",494,82,412,178.366378814792,172.878270346524
"6754",491,88,403,204.921376489169,175.097457440562
"6755",478,83,395,198.620065946735,179.060939844435
"6756",493,85,408,195.692121651448,181.030085239426
"6757",470,77,393,200.584565661744,176.269327388891
"6758",484,83,401,195.293452908378,175.616029775143
"6759",495,89,406,194.446296791809,180.111171783009
"6760",479,88,391,192.352243257287,182.221161039273
"6761",480,88,392,201.648273406129,172.283565262513
"6762",475,87,388,201.976431350225,180.236424714772
"6763",492,95,397,193.682675267429,179.224063709694
"6764",488,78,410,198.421436596276,175.282692357292
"6765",480,82,398,198.493518076522,174.191807401081
"6766",474,81,393,198.132322646783,179.942411383268
"6767",469,79,390,186.046738709248,180.9032443627
"6768",487,80,407,199.822476611984,172.399228055961
"6769",461,88,373,201.850113936228,176.465498806326
"6770",480,81,399,192.641369959452,181.258073316835
"6771",483,83,400,184.720297339612,177.600145750682
"6772",481,89,392,199.484510505569,177.966744828293
"6773",469,78,391,179.004573030263,180.910181095081
"6774",481,89,392,194.288903056737,173.219150657857
"6775",472,85,387,195.100167459977,181.221966266541
"6776",478,87,391,200.535897679871,170.42409999713
"6777",478,85,393,200.344068472358,175.230431686064
"6778",482,84,398,191.75790549568,181.169571711619
"6779",488,89,399,179.995304083663,175.760139808475
"6780",500,95,405,185.540016292437,173.765351082732
"6781",475,80,395,198.582779073679,170.030326784266
"6782",468,80,388,198.164936606001,180.326222433889
"6783",491,84,407,186.502864160919,179.115212399905
"6784",484,77,407,188.233199522963,182.157842845523
"6785",473,80,393,188.138277220015,180.35406908223
"6786",477,92,385,192.842654336353,172.528191161857
"6787",498,83,415,194.367090266617,169.725929175669
"6788",493,88,405,196.582915171256,179.97553587505
"6789",477,81,396,195.629785784082,171.795731855709
"6790",507,98,409,195.456717507776,175.420525122678
"6791",489,88,401,196.687211780679,174.611205427364
"6792",482,91,391,196.307272165722,174.614763295398
"6793",475,85,390,195.135247579043,178.741648960057
"6794",503,91,412,187.384408428029,177.052613491903
"6795",484,86,398,190.722510727819,175.263732579564
"6796",475,87,388,190.507480183114,189.308470129863
"6797",488,85,403,188.663310677533,179.410525828172
"6798",482,83,399,201.026474002288,183.851838068724
"6799",496,88,408,193.455832972437,175.75774174275
"6800",486,84,402,197.309287153958,181.632609017056
"6801",483,88,395,202.221875296751,178.941983176779
"6802",484,82,402,186.259744384006,173.606344440625
"6803",462,85,377,197.289080364702,174.294851857497
"6804",495,86,409,194.249656647416,178.149047551135
"6805",486,85,401,179.264815492687,176.024840593566
"6806",483,89,394,192.735276770566,181.112578820791
"6807",478,89,389,191.946987838011,174.351448012477
"6808",482,93,389,184.591930153719,174.690357672848
"6809",466,77,389,193.46048905333,177.698225705498
"6810",483,83,400,198.707254901497,181.874282168677
"6811",494,92,402,189.168494820398,180.112244299918
"6812",480,85,395,192.648514722806,167.33029532903
"6813",467,76,391,205.42808299713,181.405747310104
"6814",492,85,407,193.92443171692,177.115846308713
"6815",494,87,407,191.655355672527,178.208421724443
"6816",481,78,403,204.214815456587,174.270741678597
"6817",475,82,393,188.397105867052,178.275788562557
"6818",478,82,396,205.881537852647,177.613126745574
"6819",492,86,406,201.386150377271,182.313863693909
"6820",486,85,401,192.366343891174,178.071303231811
"6821",485,80,405,199.514170328198,172.502097634912
"6822",478,85,393,191.861417646116,182.269014691879
"6823",478,88,390,200.7208251641,175.492977801894
"6824",483,90,393,197.696168774177,177.996293737933
"6825",489,86,403,206.163602412826,175.86756275655
"6826",480,80,400,192.546029709912,175.168216322284
"6827",488,93,395,200.172865103608,181.507790945217
"6828",478,89,389,188.065925816696,180.138356010777
"6829",482,80,402,194.330849123151,176.603954830834
"6830",490,87,403,184.611615971124,175.392190156475
"6831",484,84,400,190.856174392798,180.752563405258
"6832",487,80,407,200.216303234612,179.683722579944
"6833",497,88,409,205.785688910828,175.080779265875
"6834",488,82,406,201.077626349604,175.666024852183
"6835",489,87,402,182.797280198482,170.22903585703
"6836",480,92,388,191.303706632008,176.136771871647
"6837",483,80,403,195.366612309298,184.832708859112
"6838",487,82,405,187.101063808718,173.22965799791
"6839",475,87,388,191.537276023204,176.194820555616
"6840",487,96,391,192.116021693162,173.896582339801
"6841",473,83,390,201.115807432253,177.418183031862
"6842",482,80,402,199.6682188124,173.022348030009
"6843",501,94,407,193.38027870808,171.609337760336
"6844",474,81,393,196.132500879975,177.666263588486
"6845",472,75,397,210.736955336833,177.715232199099
"6846",491,90,401,197.026549918239,172.099308726138
"6847",494,89,405,195.254640898611,180.217128665788
"6848",497,86,411,195.44483473189,178.662705500753
"6849",504,89,415,180.746642038793,178.287597267225
"6850",487,89,398,189.160543225924,176.20113547518
"6851",480,85,395,206.266316248196,170.378534193876
"6852",486,85,401,196.242674985235,177.776724717366
"6853",471,79,392,205.461607131319,174.988228205735
"6854",496,91,405,202.689574193766,174.848921502638
"6855",494,85,409,205.759923268259,181.689212655051
"6856",479,85,394,192.360983339226,183.108337974074
"6857",487,85,402,201.776738058376,179.247713198347
"6858",478,88,390,188.415870456355,174.896390334237
"6859",488,86,402,188.959280231412,172.637434887268
"6860",482,83,399,195.176159982528,178.682243941276
"6861",479,86,393,183.197291099012,170.358916616418
"6862",493,82,411,184.141303975767,182.091970652241
"6863",465,86,379,184.739045771159,170.764444966647
"6864",484,89,395,197.270484742399,173.234680946428
"6865",496,83,413,186.834741531503,178.011782710738
"6866",479,80,399,188.707478009239,177.79312254806
"6867",497,87,410,198.977448685064,173.166989201298
"6868",484,86,398,193.410281090156,175.56912798531
"6869",478,90,388,185.729157909953,180.605319881148
"6870",483,78,405,189.434280573299,176.109045017623
"6871",480,77,403,193.049260735218,173.277038389136
"6872",496,86,410,201.447528532368,178.594685786801
"6873",487,94,393,192.70807780829,176.57240338876
"6874",483,93,390,181.995719422253,178.991038171328
"6875",494,86,408,187.541614007474,177.344360707989
"6876",475,84,391,203.419498044064,172.848475625101
"6877",486,87,399,193.314857495672,172.707768919945
"6878",481,91,390,194.852204363413,179.91329138762
"6879",486,89,397,180.250634509054,182.642879491155
"6880",468,88,380,198.941447964468,171.990695697705
"6881",486,96,390,181.892859186795,171.22556978086
"6882",466,84,382,200.887872218109,170.958126904047
"6883",497,91,406,188.616941950201,175.10873233804
"6884",479,90,389,203.067781097429,178.140314324285
"6885",480,83,397,207.586767000263,178.445310514456
"6886",484,83,401,189.673090514245,174.800017926002
"6887",495,94,401,177.351396777308,178.573052286093
"6888",484,80,404,189.083095168434,178.481602746117
"6889",466,77,389,206.66935849221,185.699597033138
"6890",487,90,397,205.712880380103,174.457379632702
"6891",491,95,396,191.390661121225,175.140400431821
"6892",484,79,405,194.784863831933,178.058478840143
"6893",490,90,400,195.485470702636,178.215768243355
"6894",499,92,407,207.129529363299,176.033375619103
"6895",491,92,399,194.333294595897,177.322773643056
"6896",465,77,388,200.248193751883,177.386682234071
"6897",489,90,399,197.505150690556,177.622774356913
"6898",492,91,401,180.862547743679,181.79898745261
"6899",473,75,398,199.501140895177,177.512692118177
"6900",484,91,393,198.009779337559,176.172641527326
"6901",462,83,379,210.702420860311,174.407563957006
"6902",485,82,403,215.968704999762,181.780877617009
"6903",479,84,395,194.078921311517,176.074047640259
"6904",507,92,415,200.824932569822,174.191261679264
"6905",483,89,394,193.28504838522,173.78882595764
"6906",497,86,411,191.467828816542,174.36042445536
"6907",485,87,398,199.360619572207,183.224688664935
"6908",474,83,391,194.110567322524,181.582128585121
"6909",482,83,399,195.999006176721,178.330907125356
"6910",489,86,403,191.170095972884,179.424194696798
"6911",494,88,406,181.708193482435,174.046619894143
"6912",470,80,390,194.675567971832,178.602343240051
"6913",479,85,394,197.944458448817,172.066706788618
"6914",466,88,378,187.411671431225,172.188923418817
"6915",476,86,390,208.472110443181,174.900404931888
"6916",475,84,391,208.115349996951,170.743546838694
"6917",493,87,406,178.83526019446,177.759584793769
"6918",490,80,410,200.226072232429,178.08323714862
"6919",474,81,393,204.084601744193,176.316720006098
"6920",488,84,404,194.329831392288,182.979709146579
"6921",481,82,399,204.009966318859,176.432302041062
"6922",475,80,395,205.36376708647,172.537023738995
"6923",479,79,400,192.435730349357,176.095663748073
"6924",462,78,384,200.002060623532,179.680578753752
"6925",490,89,401,182.043720671232,178.255399234214
"6926",477,82,395,204.998105862755,176.580186634569
"6927",502,88,414,191.280642400344,181.818475841391
"6928",484,84,400,188.265658069794,173.025087343865
"6929",492,90,402,200.797268291417,175.30403883499
"6930",476,83,393,198.454152531441,177.086740209529
"6931",478,88,390,198.385478345746,172.211113000395
"6932",478,89,389,194.595625588526,184.847467922781
"6933",493,86,407,192.193079601818,179.808667474892
"6934",479,78,401,197.713059095695,175.20691896302
"6935",477,82,395,190.057842524273,171.887567809991
"6936",485,87,398,200.666170213653,185.585245882932
"6937",475,83,392,193.623700413216,176.957251629827
"6938",482,88,394,201.387220852141,184.720602097416
"6939",488,84,404,198.0406755619,168.033061415187
"6940",483,86,397,203.802559275942,183.867895837902
"6941",465,79,386,194.844608974183,181.919751607118
"6942",478,80,398,198.33539293172,180.270934212621
"6943",481,86,395,193.060776591342,176.596807163413
"6944",486,90,396,205.358817818556,173.719185210975
"6945",481,93,388,206.949654564419,179.533696069916
"6946",463,84,379,188.706032531194,168.692733485327
"6947",478,76,402,196.702455839865,181.465780690469
"6948",460,79,381,198.568761078028,179.587920263443
"6949",484,85,399,202.898499051094,174.965551367557
"6950",496,92,404,183.117406014218,175.845035525926
"6951",464,80,384,207.399215885663,174.426548006094
"6952",481,83,398,198.90572910453,175.143659572787
"6953",490,88,402,183.553708334238,176.837353876117
"6954",494,83,411,194.529905253226,180.918772589884
"6955",478,91,387,188.652603794069,176.908973956495
"6956",484,88,396,198.770249560646,171.183976957156
"6957",484,83,401,195.93593301436,179.244485977252
"6958",483,88,395,191.800534615087,170.610557986797
"6959",475,82,393,200.327972536992,174.41122823837
"6960",483,85,398,201.191140746639,176.555587628363
"6961",480,77,403,205.945100089154,176.395759787475
"6962",481,79,402,196.22639606251,176.043327673444
"6963",483,83,400,188.597383384839,172.803709732697
"6964",484,83,401,193.953879581048,170.611505835167
"6965",488,84,404,194.714415731917,172.517876510689
"6966",500,85,415,206.096874499912,179.552255092202
"6967",484,83,401,204.204826286294,175.852706421989
"6968",480,92,388,191.439510560583,176.968501467603
"6969",491,89,402,187.84960289374,182.564572565394
"6970",483,81,402,185.289598450643,169.288766079988
"6971",488,85,403,199.038658091524,173.528042957332
"6972",481,91,390,200.506204913187,172.511797643682
"6973",477,73,404,191.709753688065,174.193194652609
"6974",486,98,388,197.121260135452,172.793848162183
"6975",477,94,383,211.842301583059,177.977184838759
"6976",488,86,402,190.89807976939,175.339604258249
"6977",476,82,394,203.311929458545,177.845137248523
"6978",475,88,387,196.560228817481,183.71439642748
"6979",488,89,399,184.912703315653,172.142084767127
"6980",483,86,397,186.163946444382,178.012549926514
"6981",477,83,394,195.566636726292,174.235642115053
"6982",492,88,404,189.874043995063,182.534814331829
"6983",477,82,395,196.747439486801,174.053173018695
"6984",482,82,400,192.177813383516,179.258196494681
"6985",470,85,385,202.941890987948,174.235507670749
"6986",488,79,409,189.529797263744,176.539621615682
"6987",495,85,410,201.828462966969,173.793076311773
"6988",480,81,399,188.600660627186,171.900929492691
"6989",482,85,397,202.769498411464,174.960980058166
"6990",462,85,377,182.180985363048,179.16000455526
"6991",495,87,408,194.059014776414,181.319415814673
"6992",498,89,409,193.408534360993,174.214888843784
"6993",488,90,398,186.150668331702,182.593804919671
"6994",486,90,396,183.879582993226,174.426629630242
"6995",490,93,397,187.444023229338,172.860725337914
"6996",496,85,411,195.528563440436,179.650286132215
"6997",490,85,405,191.130482532988,180.655258793733
"6998",470,85,385,210.999324495903,176.861638373013
"6999",464,78,386,196.929760345855,173.649089314549
"7000",488,83,405,209.288146809046,175.025302560156
"7001",497,87,410,206.636256235525,176.227011373121
"7002",473,90,383,181.18333663891,179.541620357223
"7003",479,90,389,189.559340580085,178.212550525106
"7004",471,80,391,194.667055324406,181.353993012576
"7005",477,83,394,194.422674099861,173.040619175229
"7006",486,85,401,197.888020410203,172.513674519682
"7007",505,87,418,196.485984421788,177.801233972363
"7008",491,84,407,200.644933318296,174.031324791498
"7009",486,81,405,184.971264910225,176.725896780587
"7010",490,81,409,176.287152522452,184.25179868876
"7011",489,86,403,201.886832849436,179.606852396071
"7012",474,87,387,201.796677131568,174.431990983611
"7013",499,90,409,188.395271367931,177.801968236783
"7014",470,84,386,206.608601990486,178.417310233424
"7015",500,72,428,207.906199815304,178.384552329241
"7016",468,79,389,204.931860143197,173.464143635589
"7017",475,93,382,192.249026158677,175.587777710125
"7018",478,86,392,196.572772279173,175.640985313273
"7019",498,88,410,201.210326263691,174.760816162695
"7020",484,87,397,209.951118832305,172.522013821226
"7021",488,89,399,190.488478320225,179.689071052017
"7022",488,84,404,198.606724946077,178.275735982259
"7023",499,84,415,200.654937283096,181.009653689723
"7024",473,83,390,188.250769122544,173.79052199967
"7025",475,86,389,186.160250996709,178.826262711277
"7026",486,95,391,194.441782592771,175.007493230649
"7027",492,86,406,187.711424661273,174.392883874472
"7028",491,92,399,191.627709688383,180.820506806065
"7029",498,87,411,194.732256790241,173.451654312013
"7030",467,81,386,193.278355853043,175.405030499154
"7031",480,86,394,195.044118641942,175.179025618592
"7032",496,92,404,209.487767758848,177.02026803439
"7033",490,82,408,194.300878990822,172.913943052449
"7034",481,84,397,188.115157296287,184.624065241829
"7035",477,82,395,209.441838320291,180.486096090322
"7036",484,91,393,190.666827120467,176.949653482896
"7037",481,79,402,193.390912922599,175.966099666714
"7038",484,84,400,190.984462261013,166.521227657645
"7039",478,88,390,206.735857875489,174.16408330024
"7040",468,87,381,198.104368486274,177.557742845732
"7041",483,88,395,187.529376326552,174.208068682274
"7042",484,82,402,194.51738165733,178.004627636377
"7043",493,87,406,194.621179983884,176.286762118545
"7044",479,83,396,192.609512660009,176.523719495065
"7045",495,93,402,188.532894047487,175.084186985756
"7046",490,85,405,188.639720237052,177.065772860469
"7047",486,87,399,202.913738198723,173.008145498994
"7048",495,86,409,194.328762606849,175.316314343542
"7049",460,82,378,190.592518085445,172.293061449107
"7050",484,91,393,208.679611345742,175.096159423782
"7051",487,72,415,200.655816389213,181.419763321535
"7052",476,80,396,205.248399526419,177.25652632718
"7053",484,83,401,189.253517861387,173.908382992858
"7054",488,83,405,184.210963753348,182.765555219525
"7055",492,80,412,193.982100009111,181.218494690201
"7056",477,89,388,199.277218815099,170.569248302055
"7057",496,90,406,192.887854085893,183.849295725398
"7058",478,84,394,197.154275494284,175.090575893056
"7059",481,84,397,204.776360644104,176.993964712053
"7060",483,82,401,198.220867337213,174.447566470347
"7061",473,86,387,191.394433766218,174.467733586746
"7062",495,89,406,205.319240162157,176.4303957835
"7063",495,89,406,189.398918801208,175.637967032187
"7064",480,87,393,197.514797202316,183.595868055929
"7065",502,93,409,203.841694428833,177.047233228166
"7066",495,93,402,186.156355108644,175.375823146467
"7067",492,81,411,186.067202636271,173.443129839957
"7068",482,80,402,205.386135175427,180.032263291346
"7069",476,83,393,190.942990371648,172.472010954063
"7070",453,82,371,202.325462222116,172.822259926916
"7071",494,89,405,192.964848641998,174.346767029425
"7072",492,87,405,185.996494852908,181.626414447982
"7073",489,87,402,181.876718823395,183.549181903289
"7074",467,87,380,190.853403371367,174.933713634212
"7075",492,84,408,190.247702889354,171.495584246161
"7076",484,89,395,200.517929443062,176.288524098413
"7077",479,85,394,192.067757296123,174.680529764971
"7078",466,86,380,183.125410874359,179.542812100723
"7079",480,87,393,186.349241636215,169.902067529717
"7080",488,84,404,191.498058084578,173.95987154443
"7081",496,79,417,189.831691565173,177.908685295203
"7082",502,85,417,203.518511833138,179.479839398591
"7083",495,89,406,183.891811590901,177.056000816421
"7084",471,90,381,189.500629169638,172.47715810762
"7085",479,91,388,187.894449973126,176.998912087817
"7086",469,87,382,196.218513699563,175.185386451285
"7087",495,93,402,198.857018138872,177.824800960139
"7088",474,74,400,205.85575469921,175.369599445138
"7089",477,85,392,196.579891946782,178.482648261043
"7090",481,82,399,184.70270974797,179.000053671286
"7091",458,86,372,189.676504613256,177.112051295429
"7092",477,84,393,188.606146339072,174.07817539102
"7093",468,83,385,197.035109142668,169.204761372024
"7094",479,82,397,202.24225586971,180.923615447588
"7095",489,81,408,178.492847015257,176.631111036917
"7096",480,83,397,185.656814184017,175.291446907747
"7097",497,91,406,186.420192776498,177.060308235642
"7098",492,88,404,194.555668504443,177.676376935536
"7099",485,80,405,192.903186853689,170.926046902639
"7100",489,91,398,204.869674745499,182.958455283751
"7101",460,82,378,189.983120785301,170.74784025267
"7102",470,85,385,206.710495992643,170.413313936975
"7103",491,87,404,188.171862614269,181.775208601732
"7104",488,87,401,207.280580147632,174.658153573476
"7105",486,87,399,199.173870149533,175.461691257406
"7106",488,87,401,204.889093398575,177.631355360425
"7107",488,85,403,201.814746617447,178.24259167635
"7108",478,84,394,181.431326866678,170.639905854788
"7109",494,94,400,199.777436109258,175.593951954056
"7110",486,84,402,187.910757653742,171.724993189891
"7111",490,92,398,195.420479358396,174.444933745104
"7112",477,82,395,188.136042370288,181.750746158243
"7113",481,87,394,196.885730987718,176.756050780333
"7114",490,87,403,192.058675990817,179.285602932377
"7115",496,91,405,188.06678711949,175.906091130665
"7116",463,77,386,196.528916798965,173.564915784183
"7117",496,84,412,196.448756893346,175.553509675289
"7118",468,88,380,203.271564773223,175.769434188629
"7119",491,81,410,182.583073144977,180.491994163973
"7120",488,80,408,200.234741298394,175.573171909837
"7121",484,90,394,191.028628864826,174.373588097273
"7122",488,80,408,200.688141279631,175.939861195307
"7123",485,84,401,206.596090654231,175.760211449063
"7124",487,89,398,186.667765412441,175.943809820277
"7125",498,84,414,196.786129402599,179.280074728287
"7126",478,83,395,189.212461510952,174.98603132752
"7127",487,95,392,189.510782346823,173.336475046366
"7128",482,90,392,187.218837537616,178.612879163761
"7129",487,95,392,195.474000065253,175.923728450563
"7130",493,95,398,197.85662171233,178.533155293823
"7131",481,80,401,205.326056437187,179.577837940269
"7132",483,82,401,198.581182622455,177.720581935881
"7133",497,91,406,190.410593300629,176.353380793632
"7134",480,80,400,205.71111667249,176.909800517074
"7135",491,92,399,211.672091928928,173.5986213088
"7136",482,88,394,195.459155649194,177.786928213972
"7137",479,82,397,194.983557406074,176.975100815353
"7138",489,75,414,195.833115701412,175.390165536156
"7139",486,85,401,183.721415641762,176.508425013002
"7140",490,83,407,196.536092196295,182.180565077503
"7141",480,86,394,202.522805590707,178.699619973561
"7142",496,88,408,210.595032719003,175.216144522624
"7143",488,89,399,183.39600578126,175.506569852129
"7144",477,82,395,208.312525475703,178.674631448477
"7145",491,79,412,189.830574591536,176.359029993968
"7146",481,85,396,194.536875789146,180.147854582823
"7147",481,81,400,183.691508075303,180.11183969201
"7148",500,83,417,186.647400848296,172.418922452547
"7149",489,82,407,204.286730231107,171.131592427578
"7150",482,85,397,203.757672905547,176.751433205633
"7151",477,87,390,189.326586547933,178.487830325486
"7152",489,86,403,203.05552640279,174.322549550735
"7153",489,90,399,179.870684743266,182.69685046657
"7154",502,86,416,190.66898354613,176.875228698658
"7155",480,82,398,199.855777775693,177.386150500847
"7156",470,88,382,195.528441323064,174.168564482673
"7157",472,86,386,195.352985815396,179.932745161539
"7158",463,86,377,210.018125097704,175.266339260356
"7159",481,86,395,193.893714295484,172.828282072455
"7160",488,82,406,193.217395374463,175.095661739095
"7161",476,84,392,189.066428365318,177.795576161266
"7162",481,72,409,210.284128967216,173.595634660322
"7163",489,87,402,190.965769953009,177.129325193563
"7164",494,83,411,194.379303194821,177.847039341726
"7165",485,91,394,186.660902282325,179.843040001213
"7166",490,87,403,209.133403220102,175.604548846607
"7167",490,88,402,189.689577303099,177.714917017283
"7168",477,88,389,196.604276794884,176.467438716525
"7169",484,81,403,191.017495334536,185.068797576128
"7170",490,97,393,185.790419794806,175.643247839639
"7171",483,74,409,197.217795522781,177.450195630877
"7172",483,82,401,210.711459867638,177.664519050623
"7173",480,88,392,195.156365809487,178.411443674881
"7174",483,81,402,188.701242725546,176.46151824344
"7175",480,82,398,197.704793694877,170.607905236545
"7176",490,87,403,207.868804605264,174.23567224071
"7177",492,82,410,198.582805057098,178.855150268919
"7178",505,84,421,184.468538054016,175.465818705898
"7179",487,84,403,193.303072500393,180.989756631657
"7180",496,83,413,191.685941596904,179.951475903995
"7181",475,83,392,192.502675432528,178.889818527455
"7182",460,79,381,191.300069453144,176.123314856377
"7183",502,86,416,204.502207051111,179.99494615201
"7184",481,81,400,197.235902180811,176.408459406467
"7185",479,81,398,194.495601773448,172.704881769598
"7186",507,91,416,190.433151009874,177.598882558192
"7187",469,79,390,194.357719632509,174.309850967354
"7188",478,85,393,197.707942065058,178.03776065254
"7189",487,83,404,182.396297065973,181.36537538327
"7190",477,87,390,206.91977209101,177.546310752145
"7191",490,85,405,194.583617993939,180.102818197379
"7192",476,84,392,194.377296895806,179.485441875916
"7193",484,96,388,179.805933041947,177.43345890311
"7194",478,79,399,191.412207067618,175.736219698904
"7195",484,84,400,190.305986409596,176.963931774755
"7196",494,89,405,195.950764957647,180.871923780441
"7197",485,81,404,188.475235541539,176.81246180206
"7198",493,86,407,188.26473468609,176.201749500827
"7199",487,86,401,188.59012805297,182.603216595309
"7200",482,84,398,195.964157323148,165.608540510078
"7201",483,82,401,184.829988717242,170.916424661238
"7202",484,83,401,195.446164599301,178.363650006675
"7203",482,90,392,192.59249586654,177.689838469641
"7204",485,88,397,194.736082467945,179.336170187736
"7205",484,79,405,187.261305325799,181.56551571949
"7206",490,83,407,196.942115382597,180.802866826989
"7207",485,95,390,200.648339626287,176.009037451134
"7208",470,86,384,186.753199656078,169.864771063008
"7209",480,94,386,188.261712795635,178.995910381565
"7210",488,77,411,203.311009286729,174.150478829825
"7211",482,86,396,205.815930134068,176.01389476697
"7212",482,92,390,199.307196574804,171.343183858241
"7213",488,86,402,195.049925957643,180.103499778391
"7214",489,83,406,206.823035034636,172.36994347402
"7215",498,89,409,190.078169288549,175.000439053221
"7216",491,90,401,187.294992885116,177.109677265209
"7217",483,79,404,203.591897039493,173.693523153865
"7218",460,83,377,193.261421903584,177.479953235862
"7219",474,85,389,191.759402093259,174.718520764857
"7220",491,89,402,189.926313641788,172.842983672418
"7221",451,84,367,194.071790766331,177.426469213786
"7222",478,88,390,205.526092766502,174.493189450551
"7223",469,90,379,203.185500344222,179.090041476316
"7224",483,85,398,169.10044995979,181.857801044886
"7225",489,90,399,197.291219192002,172.441523468894
"7226",497,88,409,193.950878514599,181.250204408304
"7227",497,91,406,190.185993882006,176.801065328211
"7228",478,91,387,181.581854030959,179.022920082576
"7229",484,89,395,189.990483255518,181.514870252666
"7230",478,84,394,196.310163309424,182.312752319874
"7231",476,82,394,188.561524217447,176.667305557583
"7232",480,90,390,182.149524824794,179.618532397187
"7233",484,84,400,207.523175839241,179.160191511212
"7234",482,85,397,187.557610064781,170.794289381154
"7235",477,86,391,191.590124721154,173.251131185886
"7236",478,78,400,183.550021836522,177.383958526987
"7237",490,85,405,201.858035805369,175.761548074972
"7238",475,87,388,190.467852257003,179.180234941142
"7239",475,80,395,195.332746153812,172.971015884495
"7240",484,89,395,202.997288019433,177.451586224362
"7241",484,94,390,205.042208604761,169.840034343328
"7242",481,84,397,203.648747350419,168.145411069626
"7243",461,75,386,206.181308149976,178.796728361733
"7244",498,91,407,211.616187863853,170.768678266602
"7245",485,86,399,207.40633137604,182.346244000865
"7246",486,82,404,195.369664146816,178.564559095539
"7247",486,86,400,183.309587387064,177.497622630713
"7248",489,91,398,182.803379371956,176.927921909071
"7249",486,82,404,204.200246231165,178.925166649668
"7250",483,90,393,206.283026893447,176.951475987185
"7251",487,90,397,192.181100411482,175.818701835402
"7252",489,87,402,191.904463244662,176.164970891468
"7253",485,92,393,178.887223947166,181.326409411299
"7254",468,89,379,199.785412192913,170.419309783793
"7255",471,86,385,201.631966175778,177.292237461762
"7256",491,84,407,199.788393081227,173.731649654123
"7257",478,84,394,200.877961332508,169.04976542286
"7258",497,90,407,184.062679062182,173.939204278431
"7259",485,83,402,191.117094660381,176.709991702213
"7260",471,88,383,202.875704209066,173.747653089968
"7261",497,94,403,193.253093421755,174.114177991967
"7262",474,87,387,200.953494855085,175.494849824472
"7263",489,86,403,187.705217437735,177.389047269083
"7264",480,86,394,186.614321367109,177.822698351775
"7265",486,89,397,203.593413620644,174.386267579607
"7266",470,93,377,193.354273670899,172.58503829462
"7267",484,83,401,187.940524892626,176.855842173011
"7268",496,94,402,188.556950904749,173.376648261704
"7269",485,90,395,193.803765058018,174.845469494595
"7270",485,88,397,196.809441384832,173.106913334052
"7271",480,90,390,186.631318218375,172.963432665374
"7272",483,98,385,181.585682440058,177.272841847333
"7273",489,96,393,183.077807665946,179.776603977605
"7274",485,89,396,187.116092934285,176.570645161332
"7275",463,88,375,182.727949998362,179.521424435411
"7276",477,89,388,175.550318535006,169.891807968371
"7277",504,93,411,178.751399673174,177.697111292928
"7278",496,89,407,191.147205326838,176.435453151731
"7279",512,96,416,197.919927093632,178.524374717506
"7280",483,81,402,183.609005839488,175.102546736799
"7281",470,81,389,198.418063014088,179.174476347589
"7282",475,89,386,190.675600649386,171.484894154676
"7283",475,86,389,199.548493538463,177.331247399652
"7284",486,86,400,203.981886459265,179.74278606132
"7285",492,80,412,193.1468118184,178.676886147724
"7286",496,83,413,205.565216819061,178.936600395355
"7287",497,84,413,190.813357197938,172.968295964243
"7288",490,85,405,196.975089908735,177.812792630804
"7289",494,83,411,184.086950947263,178.64522540165
"7290",482,86,396,212.252409726685,177.680850791254
"7291",496,94,402,187.728446198002,171.55363112103
"7292",465,76,389,189.341193418241,177.531180731896
"7293",486,88,398,196.490668612101,178.387346589565
"7294",484,81,403,206.309764403379,178.415566930162
"7295",498,89,409,186.574370440435,184.545860399916
"7296",478,91,387,188.323345336034,176.519607418161
"7297",485,90,395,197.264970446898,176.231031512119
"7298",488,88,400,184.946818618916,178.917867183291
"7299",471,81,390,183.585237027169,181.231428451801
"7300",493,89,404,192.500903496006,173.385369646945
"7301",478,84,394,212.62656173635,175.391445900371
"7302",478,90,388,191.074496607347,180.156882566457
"7303",489,90,399,190.684882187911,178.371097072828
"7304",493,93,400,196.033554607086,173.540018540945
"7305",485,79,406,210.83410935906,176.239223963794
"7306",482,87,395,190.900002242327,179.799450338334
"7307",494,85,409,196.552508280423,183.321519761159
"7308",476,82,394,191.407472194615,174.491585605388
"7309",476,85,391,193.782861946108,172.840674406967
"7310",494,87,407,198.155647070489,179.732817204653
"7311",478,85,393,195.952381735517,176.377391898427
"7312",502,85,417,201.170410260013,177.073861727881
"7313",484,80,404,194.419951658858,175.014308616286
"7314",478,94,384,181.721663651538,182.046529997756
"7315",497,85,412,198.98591530483,180.66570393387
"7316",488,96,392,187.439575025345,175.041961345904
"7317",501,87,414,190.98583785348,176.497488304441
"7318",490,88,402,193.193369267339,175.411864315843
"7319",480,82,398,189.119174024237,179.379990177848
"7320",478,87,391,203.412797090454,174.55715991977
"7321",492,85,407,195.561984659278,178.185425779828
"7322",489,88,401,191.186298766635,169.46449375921
"7323",492,91,401,188.653005832136,182.956273224946
"7324",489,90,399,186.854471737786,184.255351040519
"7325",481,87,394,210.993980090403,174.586646482487
"7326",487,86,401,199.429913405014,179.282109237445
"7327",474,83,391,194.810750267316,180.641962618994
"7328",477,83,394,183.629592804957,183.140330551889
"7329",478,89,389,192.831804015639,182.04507505883
"7330",487,88,399,186.582885121562,180.161941142848
"7331",487,84,403,190.055445306458,173.689612734838
"7332",503,92,411,182.438043317099,177.470842730855
"7333",475,77,398,187.977216797326,179.710765209094
"7334",490,90,400,201.583309567337,172.937243715161
"7335",482,86,396,189.276881208752,171.184928704238
"7336",471,85,386,179.681766009221,183.339433769661
"7337",488,85,403,199.908092426539,176.977965633051
"7338",478,90,388,189.4768913894,179.611817112986
"7339",486,83,403,198.968572026083,173.866800313178
"7340",489,85,404,195.527513095286,179.588149739594
"7341",479,84,395,200.333285119769,177.796329022362
"7342",496,84,412,187.265086621236,175.625800890481
"7343",507,89,418,187.429810198704,177.489403115903
"7344",472,86,386,190.062266367368,172.606512049088
"7345",486,86,400,205.355030882136,172.572403349801
"7346",484,91,393,195.250410704501,173.814841806531
"7347",478,87,391,198.687602070173,182.917558467344
"7348",476,85,391,192.43652828573,176.643693967211
"7349",494,82,412,225.15825155922,184.102806481421
"7350",478,91,387,191.96036399477,186.697470458479
"7351",490,80,410,198.981663740712,173.455245942468
"7352",480,78,402,195.742601045743,174.028499093797
"7353",474,84,390,189.544461694039,171.457379026185
"7354",482,88,394,176.693915454151,175.934277211794
"7355",482,87,395,193.020740324311,166.807373700931
"7356",484,87,397,188.332420060442,179.203967440317
"7357",489,89,400,189.689080347099,176.153630225712
"7358",484,87,397,193.719800853975,174.675298762834
"7359",487,86,401,191.167717195718,178.755147308575
"7360",487,84,403,203.407149007431,181.35405872747
"7361",491,83,408,201.844967090901,178.368877157873
"7362",484,85,399,196.680984531782,176.027356681033
"7363",478,77,401,200.691334212211,175.251251226472
"7364",486,87,399,199.710272007264,178.84214438978
"7365",479,92,387,189.060501451477,171.541459160065
"7366",478,85,393,195.65927003149,179.082729633156
"7367",472,82,390,195.132775020048,175.36042691278
"7368",503,92,411,193.561141982204,178.985943189113
"7369",483,93,390,196.913311778108,182.03739419083
"7370",481,89,392,196.811932750128,172.928518432167
"7371",492,81,411,203.21242346667,173.526577227601
"7372",476,85,391,192.952777404848,180.582368892421
"7373",481,92,389,194.565473904507,173.272903840535
"7374",493,96,397,181.157132389425,173.53635099885
"7375",482,79,403,188.419281687587,177.093987492492
"7376",482,91,391,201.649556000463,177.263666591141
"7377",495,89,406,190.949299003195,173.549713880485
"7378",496,83,413,185.36370518658,178.889076071914
"7379",503,84,419,194.298112820277,175.144595997439
"7380",473,84,389,188.53621234738,173.502719463108
"7381",490,86,404,199.89969645928,177.439336393414
"7382",509,86,423,219.524927071345,179.182874788903
"7383",490,90,400,204.221184849701,176.139783109542
"7384",493,92,401,187.334795130209,180.624992473222
"7385",482,86,396,186.176536349811,178.438316041049
"7386",487,83,404,204.535766560563,180.715155882717
"7387",477,88,389,205.782363575045,177.725368112614
"7388",482,80,402,195.905563133496,169.084695985165
"7389",473,83,390,207.088039067734,176.450166490681
"7390",492,89,403,180.162394049899,177.642201620439
"7391",478,89,389,193.107924537278,178.304886933984
"7392",484,86,398,197.684046557989,174.346661573832
"7393",482,88,394,192.795167408651,180.629874556118
"7394",488,81,407,209.951826980842,182.679025279941
"7395",479,79,400,192.147990496079,180.153551380437
"7396",485,84,401,193.518985627839,179.101901374788
"7397",491,92,399,187.766545087814,173.347845560776
"7398",490,90,400,195.862566668523,175.24809994909
"7399",471,76,395,208.883703459153,173.217803854428
"7400",480,81,399,210.133904249825,179.53676386128
"7401",457,79,378,195.322919593075,176.727468095736
"7402",484,88,396,190.537905110069,179.41246158911
"7403",494,88,406,190.083943974501,171.965001569447
"7404",488,82,406,184.220792226539,178.829552776019
"7405",498,82,416,210.16984533398,171.448305583479
"7406",487,92,395,202.991780182553,182.077383767307
"7407",493,83,410,201.609436756076,176.016975086128
"7408",485,87,398,191.308393760381,176.457538264313
"7409",494,93,401,191.075568297533,168.524440520083
"7410",493,90,403,205.01127737341,173.43500641216
"7411",481,90,391,182.130371877255,179.208612829148
"7412",488,83,405,192.307633507096,168.033986316
"7413",467,82,385,198.472120268639,179.248100609531
"7414",478,87,391,202.761781979205,172.653634919565
"7415",490,88,402,200.895362880408,179.786539779233
"7416",496,85,411,195.390945539575,172.23586776492
"7417",495,91,404,196.54080124785,178.821572623784
"7418",490,79,411,193.138042267895,173.101103212908
"7419",486,86,400,193.983446114524,175.089046671408
"7420",494,89,405,186.683840736736,176.02135645103
"7421",489,78,411,189.55592191773,178.001948691252
"7422",487,91,396,190.793106318189,172.096513168571
"7423",479,82,397,186.335374934765,180.117722619044
"7424",476,74,402,205.685202108338,175.729809929776
"7425",480,84,396,201.48503679218,171.705771528104
"7426",485,84,401,201.071954898941,175.640284062009
"7427",478,83,395,180.777290398298,178.200600021306
"7428",505,92,413,184.597707512277,173.885990559417
"7429",482,86,396,186.806175178287,175.186666863094
"7430",476,86,390,202.258779601559,175.357088243496
"7431",470,75,395,203.953362746525,182.329779066884
"7432",497,89,408,194.920912416543,173.121968511523
"7433",475,80,395,197.527608531125,172.248335567474
"7434",479,89,390,183.526990525046,179.344919591872
"7435",475,85,390,184.408798534766,174.236890185676
"7436",485,87,398,193.083587869442,176.897268764722
"7437",500,86,414,192.114448202923,176.374694841962
"7438",489,85,404,193.169666039641,183.415467934302
"7439",486,79,407,198.83882248069,179.480277795073
"7440",488,91,397,191.133501710277,178.906424317793
"7441",483,89,394,190.113617773425,179.794041772475
"7442",499,91,408,186.10073921957,175.049959078992
"7443",472,86,386,184.522566863098,172.668176792346
"7444",478,84,394,200.823527130868,183.655332615885
"7445",486,76,410,193.207228965506,182.72729152512
"7446",482,85,397,201.929206327684,174.841309374992
"7447",487,88,399,186.860557753172,172.896960444034
"7448",470,79,391,176.757639025178,174.559583223565
"7449",476,91,385,195.156135043594,180.45296598761
"7450",468,88,380,201.074777533227,177.043216867438
"7451",478,86,392,189.581112385491,181.464609440233
"7452",485,87,398,194.214418746603,173.807640114262
"7453",498,81,417,197.110099500822,173.590464758821
"7454",489,86,403,203.852802508212,176.201363985333
"7455",477,85,392,183.950628785829,174.595545890463
"7456",503,86,417,203.266841553902,178.542034961366
"7457",500,95,405,188.441445856966,177.016776555978
"7458",467,82,385,207.4239219041,179.883192089432
"7459",488,87,401,204.200357118689,175.00162804544
"7460",486,90,396,190.401344141492,175.744201195307
"7461",480,83,397,211.820227425783,181.017797257099
"7462",472,82,390,206.571578106681,177.16622575565
"7463",486,87,399,201.737816224596,168.632939841616
"7464",473,83,390,208.816392334499,173.436105678319
"7465",491,81,410,183.655572170421,183.488825783564
"7466",474,83,391,199.588219921114,168.832000734222
"7467",505,80,425,209.197981996862,179.588268465073
"7468",482,90,392,192.493366839757,175.783168555853
"7469",473,79,394,201.935870747387,173.618939425016
"7470",485,91,394,208.825686310988,177.501785355074
"7471",485,91,394,196.49809395226,177.359624798313
"7472",480,79,401,202.699462854931,177.596717245022
"7473",477,82,395,185.475797444335,176.333642113827
"7474",475,83,392,190.508103567007,175.441800656649
"7475",486,81,405,199.566217698749,180.771327515965
"7476",504,91,413,187.070693641108,178.657042274079
"7477",497,94,403,198.995263267413,181.236638540709
"7478",488,91,397,186.006908413056,174.985357177002
"7479",467,80,387,191.885682190506,174.535183723049
"7480",483,86,397,193.681851179166,175.635281476743
"7481",463,76,387,206.972566403221,173.477045581182
"7482",481,87,394,202.620615502601,172.691950370496
"7483",488,81,407,196.406560176175,177.588767249514
"7484",487,88,399,181.44199079691,176.342094876577
"7485",485,86,399,186.093318093561,176.65201678934
"7486",484,82,402,206.839874790654,178.046376353551
"7487",490,83,407,187.06871290544,179.704946791901
"7488",484,82,402,208.971622645363,179.105412741785
"7489",500,87,413,210.51056236637,174.928557977784
"7490",483,81,402,187.935176260689,180.629577654907
"7491",479,93,386,203.170607580113,176.996562950447
"7492",494,90,404,185.882856437643,177.358547210841
"7493",489,81,408,194.586797609143,176.884025504811
"7494",468,80,388,186.41642970025,178.622327889556
"7495",483,80,403,200.330580816453,175.168827706731
"7496",488,85,403,192.380324967879,175.180883084429
"7497",485,95,390,196.27810273323,169.223841976154
"7498",484,78,406,186.292099342081,172.142040692928
"7499",486,91,395,192.60407567687,181.238808042951
"7500",491,81,410,199.786773702024,174.305940647367
"7501",496,88,408,194.653439366824,175.74087727152
"7502",464,77,387,213.352051744309,169.722025047851
"7503",481,84,397,206.73781036577,177.568320251297
"7504",499,95,404,195.146555041464,171.252122848371
"7505",489,84,405,204.47323933406,185.114109841442
"7506",494,78,416,195.145764616139,175.105121936112
"7507",463,80,383,205.494402414056,174.909011487265
"7508",463,84,379,193.037648147923,172.003449556515
"7509",473,86,387,190.091263902623,177.357279658063
"7510",475,92,383,198.364970980593,176.972462803091
"7511",506,93,413,193.240417996841,179.117404916136
"7512",479,80,399,200.319938374849,186.648147137077
"7513",475,85,390,203.445913080542,183.073017326688
"7514",479,84,395,195.553618279937,181.66871554024
"7515",466,87,379,203.152182014266,178.331873811407
"7516",475,83,392,192.683043248346,181.325505362253
"7517",495,88,407,199.958405586826,178.800725751201
"7518",472,84,388,196.280006962133,179.881052276538
"7519",494,83,411,189.275562675522,178.35411560716
"7520",484,90,394,186.12766299876,179.391118634869
"7521",474,91,383,197.534506117633,186.304901501036
"7522",484,78,406,192.182807018358,177.343916503658
"7523",475,80,395,193.626698174952,178.420389051795
"7524",469,76,393,201.836922622055,179.730739788861
"7525",492,85,407,200.448393922408,176.421499349397
"7526",492,86,406,191.397276858604,179.756383938956
"7527",481,90,391,188.026480968616,186.034986428964
"7528",483,91,392,200.167457291821,174.913529358754
"7529",493,89,404,211.21557957295,179.689758470946
"7530",492,81,411,182.637141319657,177.480750457725
"7531",484,88,396,195.55476279136,175.633873684932
"7532",511,92,419,207.700616229867,171.986578772732
"7533",474,78,396,187.031745322842,175.525473655358
"7534",466,87,379,193.799101058964,171.862541445827
"7535",498,90,408,191.400135176418,175.196138798195
"7536",496,91,405,190.912575539066,178.193755510338
"7537",466,76,390,198.021793499794,179.621950367126
"7538",483,88,395,204.947781704688,174.315501808434
"7539",489,90,399,200.602560308788,180.117620097208
"7540",480,88,392,188.353561692913,177.878677921875
"7541",478,90,388,183.474494556429,183.643884977343
"7542",485,86,399,204.051485889647,167.208206572146
"7543",473,85,388,209.323967231241,180.765861229146
"7544",503,88,415,204.678360305362,178.451176438663
"7545",491,88,403,182.276621239781,180.78698625308
"7546",479,82,397,198.067426442496,181.404115053894
"7547",481,82,399,201.321252237076,176.350800492019
"7548",477,81,396,205.657396217922,177.942017012678
"7549",489,85,404,191.866766152963,182.38719691467
"7550",477,83,394,194.158251292735,176.474802436429
"7551",490,85,405,192.817753844542,171.366537727609
"7552",499,92,407,197.25560291313,174.204858638504
"7553",488,84,404,197.941983376447,176.446388157829
"7554",483,90,393,201.106667924399,172.345638084761
"7555",471,83,388,191.460816489497,171.362283902425
"7556",488,97,391,195.163908733154,176.592931321046
"7557",469,88,381,191.623995720786,177.106305210034
"7558",497,91,406,184.549763829146,181.120486612178
"7559",490,90,400,197.332238773845,178.323654163037
"7560",492,88,404,192.296400136441,178.864983029187
"7561",479,89,390,191.285396750428,176.321610453195
"7562",481,87,394,195.1289321236,173.423161014488
"7563",494,84,410,194.284889952399,180.956208993921
"7564",490,93,397,193.866076554018,171.080079559897
"7565",480,90,390,188.863802183799,177.112029791836
"7566",488,82,406,205.509025474345,181.492284309788
"7567",471,83,388,185.01173536157,176.166031307492
"7568",487,83,404,206.066906857376,178.791649287302
"7569",473,91,382,190.857680452382,181.634880641321
"7570",476,85,391,192.577101549107,181.833271269846
"7571",488,87,401,199.643548485283,175.1188629778
"7572",488,85,403,198.561841807794,177.091583212198
"7573",495,93,402,186.340796843919,176.961555825844
"7574",492,85,407,191.262583158068,174.907761547251
"7575",485,83,402,197.302759067236,180.181321887842
"7576",483,84,399,199.534158540948,177.238584098448
"7577",481,82,399,190.062963078283,175.077194012055
"7578",497,90,407,189.966663535556,175.228694196575
"7579",470,85,385,195.976709005721,181.140018122504
"7580",479,83,396,196.005048085884,178.594302585746
"7581",496,89,407,190.732663808738,172.415699136429
"7582",476,77,399,191.817706080708,174.265427710549
"7583",481,77,404,207.452493688865,175.690517400689
"7584",487,85,402,196.181147398842,176.893453358927
"7585",471,85,386,187.691151129877,182.666125849378
"7586",482,82,400,192.831180312201,178.223237695349
"7587",486,95,391,191.354441384001,179.826920592364
"7588",482,89,393,207.242826696548,181.057595253192
"7589",485,84,401,189.566235479592,177.80192899568
"7590",487,83,404,189.961670731396,178.573811476644
"7591",498,96,402,184.457263648775,169.829574085175
"7592",486,88,398,188.394786139271,175.506534753553
"7593",497,94,403,197.810651669258,176.532580268962
"7594",474,84,390,194.081931516138,181.886763085664
"7595",479,96,383,195.799885873898,182.030428563519
"7596",480,86,394,190.177076933615,175.969486449694
"7597",482,85,397,203.521947919623,178.963589044905
"7598",482,82,400,202.65908542373,177.298445810405
"7599",486,82,404,208.084433604321,177.676830222359
"7600",482,86,396,199.86657446337,174.551882972962
"7601",483,81,402,192.290940875697,178.727934402896
"7602",478,80,398,201.66388263594,175.352054912086
"7603",461,73,388,184.71280729982,178.839790560525
"7604",490,92,398,192.418052401336,175.267197837933
"7605",483,88,395,194.133790476185,177.718451360375
"7606",476,84,392,202.271984944763,171.606104941178
"7607",471,80,391,192.304696418521,173.461076532977
"7608",477,85,392,201.926757581686,175.166499174415
"7609",486,88,398,196.462449897262,178.257321251759
"7610",490,88,402,194.990611798235,174.845808333753
"7611",474,86,388,194.477926363384,182.366178464521
"7612",474,90,384,194.810460932231,173.514857816736
"7613",488,86,402,202.213973004602,177.249653006436
"7614",499,97,402,202.198566048951,174.133828346785
"7615",471,83,388,196.701368380628,179.866383104104
"7616",479,83,396,194.745790217366,173.73774629694
"7617",481,78,403,192.321768603324,182.276652372881
"7618",488,86,402,189.73025393568,175.728068357679
"7619",487,87,400,185.077568290589,178.190950640146
"7620",477,77,400,210.225004210604,179.467549348457
"7621",490,81,409,190.264541706556,176.955291661201
"7622",493,82,411,201.701434356464,184.136751912741
"7623",482,80,402,196.04890116979,180.178253330619
"7624",491,89,402,203.363839676179,182.397277150969
"7625",482,80,402,199.78814927378,178.9824621085
"7626",474,77,397,210.254816949903,180.288593860629
"7627",473,78,395,189.369608717615,173.934176902366
"7628",479,81,398,197.59277343755,178.683990576038
"7629",491,88,403,192.351734319614,177.305898169726
"7630",487,82,405,207.014235227736,179.78316790106
"7631",488,83,405,196.605151351021,169.493612031095
"7632",471,88,383,184.686422758097,178.003156950034
"7633",474,81,393,183.627739313898,174.926229339043
"7634",487,83,404,200.336060459763,175.831843791307
"7635",477,85,392,190.857853852406,179.529322534737
"7636",503,85,418,200.02057000062,176.589908675571
"7637",489,96,393,191.190513090955,174.926879658152
"7638",471,88,383,190.301232342046,181.578261135776
"7639",486,91,395,177.96060078672,174.299464640785
"7640",480,90,390,166.881830859508,179.995789557252
"7641",463,82,381,188.389143599409,174.140649460337
"7642",494,88,406,193.753728872837,175.837700340679
"7643",474,84,390,187.960927204063,173.574481133366
"7644",497,92,405,190.25715072526,174.721840389978
"7645",480,81,399,203.094111518618,171.110874830679
"7646",485,92,393,195.583586766183,177.13311909637
"7647",488,79,409,200.838454892899,170.518761165699
"7648",480,85,395,197.80229709683,176.213037213265
"7649",487,85,402,202.909281992906,174.388500299149
"7650",479,79,400,204.150420434119,177.215730870402
"7651",482,79,403,199.765929846122,169.928506372796
"7652",473,84,389,203.846484974605,179.528515884139
"7653",482,89,393,192.069844204002,171.579775982781
"7654",494,76,418,205.333864322753,175.318839812166
"7655",485,84,401,193.532320264717,173.809081657344
"7656",477,88,389,197.599973631088,179.668984940417
"7657",487,93,394,187.669112244241,180.255003047029
"7658",491,87,404,195.003025332655,171.922465384235
"7659",479,83,396,187.510772641805,167.63611855293
"7660",462,86,376,201.304912159908,178.806662876246
"7661",497,93,404,196.127783936257,176.532192234966
"7662",481,79,402,199.8118080877,169.923733076904
"7663",476,79,397,196.262019728378,176.488852124442
"7664",479,86,393,185.787715704563,178.524164409755
"7665",483,83,400,191.937920859914,176.484751247132
"7666",469,79,390,200.384920035263,180.859668824793
"7667",482,87,395,199.109052098946,168.739299812945
"7668",479,84,395,198.485486403844,174.554596866065
"7669",483,81,402,187.625096165119,178.829827349858
"7670",496,85,411,195.192720571626,176.179589966352
"7671",483,95,388,209.781753410589,169.514053834273
"7672",479,84,395,190.146823508654,171.081214651307
"7673",477,90,387,202.005451110064,179.878535330944
"7674",504,93,411,195.926268984942,177.319590631032
"7675",488,82,406,189.137194188352,175.542082554557
"7676",475,81,394,197.541365468656,175.212250028886
"7677",486,86,400,203.750779245469,172.954369732286
"7678",498,89,409,190.940561560178,177.938092740352
"7679",492,91,401,208.391786304023,172.104211797932
"7680",501,88,413,193.740967423306,174.156925917998
"7681",482,90,392,192.373134822962,175.997004823085
"7682",492,88,404,199.351669238746,179.853802140751
"7683",483,82,401,182.41256446974,171.76232276289
"7684",479,92,387,202.424392711136,178.451798644113
"7685",490,85,405,189.565323197934,180.487781624344
"7686",490,81,409,209.591164767385,176.307687801041
"7687",474,84,390,184.203292230245,176.995168527892
"7688",474,81,393,192.456779412116,180.662797009372
"7689",478,82,396,194.2781173389,174.736840679197
"7690",500,86,414,193.716681566468,177.74008211391
"7691",485,89,396,197.82037273189,182.520783132643
"7692",482,79,403,189.94323346954,173.386277771023
"7693",487,82,405,202.8164239788,177.573535553035
"7694",474,79,395,206.390456775717,176.905793434253
"7695",497,91,406,199.568730101366,178.912506210622
"7696",488,86,402,194.77976976527,174.560795006039
"7697",484,86,398,200.278015103705,185.637326198724
"7698",483,77,406,195.148942646005,175.72216587845
"7699",485,84,401,206.695782622878,181.895238057818
"7700",491,86,405,189.950245411222,183.78659409869
"7701",480,92,388,187.144001603283,176.25725039646
"7702",503,88,415,197.5981130825,185.890907120015
"7703",483,88,395,192.3466192659,179.993406965865
"7704",483,93,390,185.132293063186,176.192256405185
"7705",480,91,389,198.078540134341,173.828850611565
"7706",491,86,405,195.947952809669,173.186556654946
"7707",488,82,406,195.541289113842,173.338880106573
"7708",480,87,393,204.924414533415,175.908092240215
"7709",499,78,421,202.578818475047,172.297839468734
"7710",504,88,416,191.309757596262,179.750945613425
"7711",492,94,398,196.83410929148,178.237472064252
"7712",485,88,397,191.582978340448,174.81384914152
"7713",478,83,395,204.992534676183,175.386832473953
"7714",494,91,403,185.380523061653,183.294615086249
"7715",486,84,402,195.10879005746,178.644203961469
"7716",484,92,392,204.1521760055,174.09174591856
"7717",495,94,401,186.424967289647,174.419569912521
"7718",480,83,397,204.813749520288,180.462778142098
"7719",483,88,395,206.056302388037,171.965807896193
"7720",490,82,408,197.029764306009,175.630177169825
"7721",484,85,399,204.275638570977,176.798104575917
"7722",486,79,407,210.420767466614,169.672879722524
"7723",491,84,407,191.906866438579,178.642162205035
"7724",484,88,396,188.230077603507,180.247041333437
"7725",482,84,398,200.709647451896,173.26923985665
"7726",484,82,402,187.409947979991,175.925346848225
"7727",482,79,403,196.111593643524,178.427503944712
"7728",494,78,416,194.08185087642,179.575867672362
"7729",496,88,408,200.865833967914,176.913154686411
"7730",489,84,405,199.375917585076,181.568269448058
"7731",493,89,404,196.378828600952,171.729292003366
"7732",503,92,411,193.509687169196,180.261423957155
"7733",464,92,372,183.63653965564,178.613294157341
"7734",485,92,393,198.886672350088,178.534618262971
"7735",497,88,409,201.147521152817,176.363159879402
"7736",472,85,387,205.157120389115,173.457051649675
"7737",481,84,397,187.410178348001,177.367986465691
"7738",471,85,386,190.20195152515,174.817379044598
"7739",488,86,402,189.200051428336,176.405383032281
"7740",473,81,392,196.296865575043,179.604762147745
"7741",489,93,396,194.14476747094,173.646731921427
"7742",480,87,393,192.593043181,176.824283552372
"7743",494,82,412,212.049577239373,178.265998372864
"7744",494,95,399,191.864316982942,183.138441960665
"7745",481,90,391,194.14340828211,180.218334739822
"7746",478,88,390,197.942294363282,175.063236862824
"7747",499,92,407,197.117391587738,180.499778877514
"7748",482,87,395,199.924098805567,174.344179113228
"7749",495,94,401,194.485194661538,183.180890459593
"7750",490,84,406,201.186171097393,177.287740470955
"7751",483,86,397,191.024980397327,176.2590371444
"7752",490,82,408,186.543706635347,179.934811911421
"7753",482,85,397,183.013157973323,178.543073411007
"7754",486,84,402,189.949121726019,174.639307692206
"7755",476,92,384,200.83661606867,179.848111634309
"7756",488,86,402,190.845564630407,185.516203465438
"7757",473,90,383,210.012131943204,173.701699310203
"7758",498,88,410,191.837553591625,175.379966128476
"7759",476,81,395,186.815659725656,172.804306560424
"7760",494,88,406,201.686765248814,177.242348581775
"7761",491,86,405,165.047608030178,173.920540267936
"7762",499,88,411,201.401673354825,177.182894960387
"7763",479,80,399,196.533892180429,176.425233425381
"7764",480,81,399,204.71349129205,181.920784554164
"7765",478,87,391,191.167262271154,179.715600477389
"7766",480,90,390,179.270806295658,173.677604467693
"7767",499,91,408,200.867931615552,181.618784876175
"7768",483,81,402,185.735776324696,173.340736008058
"7769",470,73,397,195.174128358465,178.858862398658
"7770",481,82,399,194.401391207655,175.345319944621
"7771",469,84,385,196.035688687405,176.284579882457
"7772",483,87,396,190.391301346183,173.264227982377
"7773",497,78,419,192.646228906122,178.188395078729
"7774",489,90,399,190.549095880472,165.716773497199
"7775",480,81,399,201.521706545465,169.414323765689
"7776",482,88,394,199.205143054044,176.035848527164
"7777",483,83,400,206.082482565918,177.624913512808
"7778",497,79,418,183.34388702079,173.70785957269
"7779",483,84,399,200.310642719355,176.580430534347
"7780",486,84,402,194.82370519998,173.473697022214
"7781",477,91,386,181.472315493846,173.049578742902
"7782",481,86,395,192.552063907473,175.982476132209
"7783",483,85,398,196.331752543068,176.407613290726
"7784",508,93,415,192.856274988237,178.88905568555
"7785",487,84,403,191.443899598663,168.130688364856
"7786",462,74,388,203.069685415005,173.135345986618
"7787",479,81,398,204.92080265234,181.594124512278
"7788",493,81,412,203.267415418639,177.686105248162
"7789",484,87,397,195.501091424171,176.369122094227
"7790",485,89,396,200.356603033891,175.326298948943
"7791",465,78,387,199.92166939412,174.503250063154
"7792",471,80,391,189.956701121794,175.423800469807
"7793",483,85,398,191.522469389111,175.00075668488
"7794",496,82,414,199.903382431861,173.100906128698
"7795",468,85,383,197.341971199155,180.839963849713
"7796",497,95,402,194.677202317283,180.786907770883
"7797",474,82,392,200.072008406607,176.418480082946
"7798",480,81,399,195.564880570654,173.394731841111
"7799",485,92,393,189.65483447567,176.743310478665
"7800",504,90,414,207.62943492635,177.495811854869
"7801",482,80,402,199.115036113679,176.183775790944
"7802",468,84,384,193.711314703664,175.585527523025
"7803",467,81,386,208.359891108296,171.703119516976
"7804",495,89,406,188.376116851998,179.303195368547
"7805",481,88,393,190.885498061456,177.104911832159
"7806",478,87,391,193.961285269286,172.496112953247
"7807",493,82,411,202.855178801665,183.642527160752
"7808",489,85,404,185.476260846169,180.225620201574
"7809",488,85,403,201.736177913819,174.475824950276
"7810",490,85,405,205.084306093761,180.183580794157
"7811",497,88,409,193.496024745616,174.590267947461
"7812",468,81,387,196.56934091013,180.914574268496
"7813",488,90,398,198.439251824387,180.378971323582
"7814",470,85,385,203.392327846773,174.070762074082
"7815",481,84,397,188.682734255021,175.672761150086
"7816",465,83,382,196.375663461639,177.779870637148
"7817",486,85,401,183.716076408195,175.669079716573
"7818",473,77,396,192.051419664067,172.541072915222
"7819",484,84,400,190.111559362681,178.112314986298
"7820",476,79,397,201.455378190006,188.481709094185
"7821",484,89,395,193.99353817997,175.193269806389
"7822",482,81,401,185.312476140649,177.474466796241
"7823",498,95,403,187.49996905251,174.698423093428
"7824",495,88,407,188.95325522652,180.900755072262
"7825",490,87,403,193.748492132799,180.365257094269
"7826",490,87,403,200.113586774422,170.846724026887
"7827",485,88,397,205.617901821664,176.435533811301
"7828",484,91,393,198.344484877433,174.750643545
"7829",474,85,389,189.536542761303,178.041913607588
"7830",477,85,392,210.159347872241,172.358681466064
"7831",485,88,397,190.987970999541,175.319131565342
"7832",492,92,400,193.911914279343,172.715940271026
"7833",465,83,382,211.621401788585,175.712410713824
"7834",489,84,405,197.408844922453,179.013564215339
"7835",481,88,393,194.921057288505,180.120468473508
"7836",466,80,386,192.954760236607,178.087665498382
"7837",494,100,394,190.978084239273,174.12153421654
"7838",466,77,389,196.508540823548,181.862278844851
"7839",479,84,395,195.59938994774,167.269058083043
"7840",489,96,393,193.985590157879,175.322070716198
"7841",490,85,405,197.567108825606,173.332002320094
"7842",489,91,398,192.932976098641,176.753600035689
"7843",489,86,403,201.273854810058,172.226076658343
"7844",489,93,396,191.590670628166,169.187476563577
"7845",483,88,395,185.852064591068,179.993605565285
"7846",479,86,393,186.261155107987,176.035732308275
"7847",460,78,382,200.375762625774,174.365458211535
"7848",470,79,391,202.548433734856,173.23717893373
"7849",477,79,398,206.069790563685,176.735445667405
"7850",493,87,406,188.537385425067,180.959852984858
"7851",500,94,406,186.502995838511,184.22625426009
"7852",490,93,397,200.495654841883,173.101870992025
"7853",493,90,403,193.725342303285,174.800374188102
"7854",491,91,400,191.047658058652,174.598166434786
"7855",496,92,404,194.153691026478,171.77960069383
"7856",482,91,391,181.511055243166,180.690461278319
"7857",473,79,394,190.278629953068,179.678210431864
"7858",488,85,403,192.02554574578,178.551827184253
"7859",486,87,399,195.32175698543,173.308506841325
"7860",490,90,400,187.246760428905,173.770895301291
"7861",475,90,385,184.185580955338,177.317257654302
"7862",494,83,411,192.837130988704,180.220887752363
"7863",470,79,391,198.498118380913,178.859192681404
"7864",491,89,402,197.958022032118,175.187759635131
"7865",490,81,409,196.87135019707,173.451264175803
"7866",486,91,395,191.115394327149,179.285610178985
"7867",477,87,390,195.10987561381,177.194908918335
"7868",481,86,395,199.191474013617,175.945868921158
"7869",492,86,406,194.340488211289,180.764653134742
"7870",482,93,389,194.360414519763,180.072912987099
"7871",484,86,398,194.927633069177,169.336859501905
"7872",478,79,399,204.412743326962,174.348473508491
"7873",482,90,392,187.482056573602,172.193411826875
"7874",485,83,402,201.573634426199,174.890838386334
"7875",494,79,415,193.716534339741,179.59847020064
"7876",477,75,402,186.63651949116,175.673256261765
"7877",482,93,389,191.126971432765,173.261378415107
"7878",496,88,408,206.692145777267,168.817620120606
"7879",484,87,397,204.224276489267,182.614447334384
"7880",484,86,398,200.452199298007,175.858232618945
"7881",486,86,400,193.84343093417,184.155492466496
"7882",480,80,400,196.451504725167,181.807819839651
"7883",490,87,403,193.559081472227,171.614865144009
"7884",476,78,398,211.020366421266,177.253305580764
"7885",480,88,392,190.285531138431,179.110839764101
"7886",479,79,400,202.878909329427,174.63291278641
"7887",469,80,389,192.887382161818,179.480853515756
"7888",482,88,394,200.161818220806,175.274250562792
"7889",492,93,399,185.555486578609,168.806621839801
"7890",494,98,396,199.746835437364,177.835641392208
"7891",475,89,386,186.98033711085,174.609834848387
"7892",482,89,393,194.197481204369,179.975779632307
"7893",497,86,411,204.061715072992,173.833593313985
"7894",490,85,405,185.613645220309,178.41285374096
"7895",481,80,401,197.001316286474,182.818524043422
"7896",502,91,411,202.199347348662,174.564005055181
"7897",481,87,394,194.388057820396,176.409190033551
"7898",480,83,397,182.158229349994,172.198240476279
"7899",496,87,409,180.985971463619,180.514942815955
"7900",483,83,400,204.759999269249,174.974389576492
"7901",500,90,410,191.941893303493,169.01568529945
"7902",476,84,392,198.082518522103,178.29554169293
"7903",473,80,393,209.215450317144,179.675851236542
"7904",492,88,404,187.867329434125,175.775091366311
"7905",503,88,415,203.045184254467,176.919647627839
"7906",476,77,399,187.410503113637,175.875068748162
"7907",479,83,396,204.23117441443,182.832615486116
"7908",488,86,402,193.892558268467,182.09831201023
"7909",494,92,402,196.49810257418,179.038816801179
"7910",486,84,402,186.404580980719,173.639902966399
"7911",476,86,390,185.505404146183,172.026426216429
"7912",486,89,397,193.547080590363,170.402712681308
"7913",486,90,396,181.783722655536,181.411082416574
"7914",484,85,399,207.585511350571,180.742926147598
"7915",488,89,399,190.611168491188,176.938284493882
"7916",484,97,387,199.127005976542,179.152924132097
"7917",478,90,388,199.536889715259,184.240691315833
"7918",492,88,404,188.120061769457,176.299335430232
"7919",481,85,396,210.352649665998,172.433360927838
"7920",484,87,397,194.984710862851,179.494832809853
"7921",497,84,413,200.122620241289,180.04378537187
"7922",470,79,391,201.033183387877,176.265741850389
"7923",480,82,398,198.910115784754,176.820979912148
"7924",493,89,404,184.491180199215,172.713073024215
"7925",476,84,392,196.141650319384,173.753206334888
"7926",461,77,384,213.5020784315,181.64333641225
"7927",494,90,404,194.869095030098,174.278886500043
"7928",473,80,393,189.272617792353,180.063743641626
"7929",472,82,390,191.379459748282,175.384412853175
"7930",477,79,398,174.120396341449,171.387416630086
"7931",479,80,399,180.289303332698,172.414707276608
"7932",511,92,419,186.493228778275,172.228233909612
"7933",488,86,402,207.372195141994,178.623457483563
"7934",493,91,402,207.870012423788,179.878159154252
"7935",509,84,425,204.890802446296,178.209806780088
"7936",486,76,410,195.812468400218,177.549848386868
"7937",481,88,393,191.849530646291,177.415571890489
"7938",478,80,398,193.192189487316,177.109037298768
"7939",476,86,390,188.143730135665,176.897834487324
"7940",498,96,402,201.662206203393,171.381412378971
"7941",491,86,405,196.368326525573,172.380359554549
"7942",482,88,394,197.806368920777,181.170130011463
"7943",484,86,398,198.857212634964,175.886021390997
"7944",483,88,395,192.820750596971,176.782016712152
"7945",476,84,392,189.639978495524,179.720962870753
"7946",501,94,407,191.946939168381,183.314128527192
"7947",481,91,390,189.524747571677,174.029788004084
"7948",514,95,419,182.363951435149,175.645993623947
"7949",488,86,402,202.182289649592,184.65008950628
"7950",474,82,392,186.437765522066,178.960528023053
"7951",468,83,385,188.495751411808,178.333942516796
"7952",497,92,405,191.52031300114,172.793912441176
"7953",478,73,405,204.161819559468,176.021154071181
"7954",486,87,399,194.775283351806,175.312754306148
"7955",481,82,399,204.882843895937,174.867356290604
"7956",479,85,394,204.614202378089,174.626243563749
"7957",489,93,396,179.293498351124,180.009465509343
"7958",480,86,394,185.332884144118,179.697996048392
"7959",482,79,403,189.927371001284,180.146640958954
"7960",501,85,416,193.439357074969,178.678797343546
"7961",468,79,389,208.55705521917,173.653094957318
"7962",480,85,395,185.375391185428,176.272948440277
"7963",484,83,401,188.261206865329,173.033153676414
"7964",481,83,398,192.518433256573,172.37827308017
"7965",485,84,401,204.674383789886,177.63460004169
"7966",471,88,383,204.058716122998,177.94903280001
"7967",490,91,399,198.88209391598,177.516190403093
"7968",478,79,399,195.597486994251,177.971782564
"7969",482,89,393,186.972471000886,181.449412971506
"7970",487,83,404,198.59562958031,175.01796618534
"7971",491,78,413,208.970645875954,176.55089616369
"7972",471,83,388,199.208693644759,178.821738853211
"7973",484,81,403,182.49446675402,173.000616385322
"7974",481,83,398,184.092834695487,171.993622906338
"7975",482,86,396,191.846953748613,169.388108868
"7976",490,86,404,193.158306192643,173.532338036101
"7977",473,88,385,185.661447168939,178.328388941085
"7978",505,84,421,198.176537214907,179.627454371559
"7979",458,79,379,201.385362502638,172.347219932171
"7980",489,84,405,184.946485779141,173.582805704575
"7981",490,85,405,186.944266066942,178.318277470838
"7982",480,83,397,189.071823132862,175.830302163723
"7983",500,91,409,205.964226490549,180.66757664533
"7984",479,85,394,199.416169504782,177.561698348569
"7985",491,86,405,191.255600896611,183.199162592961
"7986",481,87,394,203.064428755203,173.638704896921
"7987",485,79,406,192.457099372193,176.726579900011
"7988",487,84,403,184.334363310123,179.228348013293
"7989",502,97,405,198.301461277626,179.801998757787
"7990",491,100,391,192.178834477612,175.494224007988
"7991",490,81,409,189.296362202521,170.299323345714
"7992",489,86,403,200.225473625284,177.289989214576
"7993",474,87,387,187.12086892177,179.757713043735
"7994",485,78,407,201.316080439897,179.540240688862
"7995",477,81,396,195.907409780489,179.268592670864
"7996",487,86,401,194.253643951883,180.806042266248
"7997",489,85,404,189.100320882572,179.227377376326
"7998",481,87,394,189.442756232269,173.106031732928
"7999",471,82,389,196.790590879456,175.7354078187
"8000",489,95,394,192.413367083495,183.496985829478
"8001",478,88,390,184.311553808357,176.235100249801
"8002",486,86,400,196.270939222659,174.844045323315
"8003",470,82,388,196.8520554055,172.894396223925
"8004",474,86,388,194.527769595545,176.793963897489
"8005",490,90,400,200.271201690529,178.216409497112
"8006",481,80,401,191.998307895989,183.846445724483
"8007",479,86,393,189.225218241121,175.309921824375
"8008",496,89,407,189.496700615455,178.142460667708
"8009",487,83,404,200.857522251281,169.919394051548
"8010",476,85,391,191.319955111357,176.335108245432
"8011",472,80,392,183.546221117841,179.675135623331
"8012",490,87,403,206.218587340997,173.536713646902
"8013",494,84,410,192.220163795329,173.039949101286
"8014",501,93,408,192.319402429934,177.251300975029
"8015",495,81,414,191.923939667249,170.736865085043
"8016",483,83,400,188.900586645194,178.391389735617
"8017",489,91,398,182.939520887902,170.857875341315
"8018",478,84,394,203.968132862582,185.162499096733
"8019",483,93,390,189.473597404644,184.394449215058
"8020",482,84,398,197.28658078877,174.357105351201
"8021",481,81,400,198.953871290121,180.639003483436
"8022",484,90,394,203.409474713123,176.095023732166
"8023",475,84,391,197.679853074754,169.241960962195
"8024",480,86,394,200.320045038828,176.793247281422
"8025",492,82,410,190.909005474586,182.207462142316
"8026",485,86,399,201.513044659498,179.499792538928
"8027",471,76,395,201.162822774577,180.5552525337
"8028",488,82,406,204.348205642635,179.240507569415
"8029",472,84,388,186.765172404519,183.788675734436
"8030",491,93,398,194.036614685119,180.531579217126
"8031",500,92,408,194.560832751162,179.099604507654
"8032",478,85,393,196.619933171584,172.101622663836
"8033",476,81,395,196.349338225424,173.563173607458
"8034",494,79,415,196.611540715459,174.078221262457
"8035",498,85,413,211.096565131,175.569974233136
"8036",496,91,405,189.052317578357,181.365520915696
"8037",481,88,393,201.74717323,179.00548720503
"8038",477,85,392,192.582743101431,171.378200359052
"8039",480,81,399,199.004058917194,178.88599625339
"8040",502,95,407,194.707206029812,171.944892888014
"8041",481,87,394,216.38215448378,179.133926989864
"8042",487,88,399,194.023227852147,185.058627238552
"8043",482,78,404,180.263024404995,173.901203928458
"8044",490,90,400,199.423733027876,178.893754178355
"8045",479,91,388,175.185673220223,176.765099644283
"8046",479,84,395,190.835945376537,176.612607949764
"8047",509,87,422,207.678683916694,182.615518533201
"8048",479,80,399,197.650724497728,176.546488617515
"8049",473,80,393,198.955100669839,182.333273901538
"8050",473,77,396,196.83197791692,176.065543008657
"8051",477,84,393,197.360603066424,175.665877806188
"8052",480,83,397,206.061016337102,177.400097042772
"8053",477,83,394,192.425294405694,172.522708092653
"8054",489,87,402,199.35560174599,179.422799883139
"8055",488,87,401,176.182875497353,178.485721946132
"8056",484,84,400,186.925078597019,177.814720494602
"8057",498,83,415,186.880996570474,173.615152879683
"8058",468,77,391,203.089330766141,175.474373819637
"8059",494,87,407,188.653478642485,173.303645736532
"8060",475,82,393,198.422306104208,172.96387139155
"8061",485,78,407,203.777074102185,176.415652620292
"8062",467,82,385,199.503076228182,179.661235693366
"8063",494,93,401,192.783544858516,168.662321475728
"8064",485,87,398,214.967013311059,182.084501607232
"8065",478,87,391,205.20187435026,173.888264127031
"8066",483,80,403,199.572189354595,174.065739216155
"8067",479,86,393,201.714953657759,175.37078898294
"8068",472,77,395,192.44374019376,173.129293446838
"8069",485,92,393,185.987908031078,178.14537539289
"8070",517,89,428,187.71222928547,176.932783827584
"8071",472,86,386,202.021390300355,170.192986428784
"8072",482,93,389,191.755725386196,178.035097357852
"8073",498,96,402,209.777925463463,179.617960673486
"8074",478,80,398,194.731944551549,183.472670217961
"8075",488,87,401,199.453263784333,174.422856695542
"8076",485,93,392,192.078696767164,170.040785715
"8077",478,78,400,202.729209215842,175.253502222644
"8078",482,88,394,200.775834778931,181.24212158464
"8079",489,84,405,192.896133790672,177.942283637569
"8080",473,86,387,191.78217677743,174.192344762607
"8081",482,87,395,194.052960733646,174.72114754779
"8082",484,80,404,196.210786834225,176.932256679124
"8083",497,88,409,194.233739604216,173.287630749831
"8084",487,82,405,193.67095749564,176.891452429183
"8085",486,87,399,198.952857712286,176.218272558899
"8086",481,90,391,202.423424821295,164.341980301838
"8087",485,98,387,193.567698272969,181.72263132747
"8088",473,90,383,190.856382863501,183.778955635351
"8089",492,92,400,193.443674427664,171.675394026287
"8090",493,86,407,187.321786910215,173.86031194564
"8091",486,85,401,184.483078672159,184.163165816952
"8092",480,80,400,198.476480870146,176.753505287452
"8093",493,91,402,199.259232209819,177.139790889454
"8094",477,87,390,192.087861049067,173.056274599047
"8095",479,91,388,207.74057035448,170.522954433912
"8096",485,86,399,197.845970200688,182.323918581634
"8097",488,82,406,202.649812007105,180.385361461496
"8098",487,88,399,199.234446478092,182.532537557743
"8099",485,88,397,202.021746719875,179.118610657856
"8100",471,80,391,201.973883693604,173.361680885471
"8101",488,91,397,196.18922223282,178.375496656057
"8102",497,89,408,193.744740898887,175.054214084278
"8103",467,80,387,196.422205535374,178.655531040218
"8104",484,78,406,181.896744583124,180.697169132884
"8105",505,90,415,198.473512169956,176.262045079891
"8106",466,83,383,202.445952915514,177.119521455753
"8107",495,83,412,189.502267725477,170.662099309679
"8108",489,91,398,192.864376166296,177.990916088184
"8109",480,91,389,197.678291266808,176.247503611206
"8110",478,86,392,192.025259744379,171.743616611839
"8111",485,83,402,191.348326731583,179.499638999743
"8112",481,85,396,198.95904041381,189.126604205708
"8113",487,84,403,198.501295263158,177.66943545543
"8114",476,86,390,192.681999094706,180.182257993261
"8115",466,77,389,207.205191406791,177.108503001196
"8116",476,86,390,187.54810267919,176.813874280359
"8117",481,83,398,201.574466700508,174.336427907758
"8118",481,79,402,185.418279377061,171.929152726521
"8119",486,89,397,191.164236343875,177.222005509099
"8120",494,85,409,202.518766390206,175.8976655052
"8121",488,89,399,177.261560265669,173.597518473352
"8122",476,85,391,191.906616992161,175.040225715627
"8123",499,91,408,200.648028781456,180.390002245729
"8124",485,82,403,207.722125044103,178.196968354593
"8125",479,87,392,206.26011242532,177.170332144914
"8126",478,79,399,190.026782107439,174.356448838613
"8127",478,86,392,184.101772926123,183.484362064777
"8128",484,90,394,190.890702947912,181.438682620013
"8129",466,85,381,201.305347079219,176.201514074836
"8130",481,86,395,203.568642854628,175.393695705922
"8131",493,90,403,197.456144207616,178.484424028617
"8132",486,85,401,193.712401183485,176.162149428352
"8133",479,80,399,197.444481334592,177.399440721819
"8134",480,86,394,204.433112554546,174.107890295766
"8135",466,78,388,197.795991438377,176.247764119736
"8136",490,92,398,202.597232449961,179.403284138159
"8137",512,92,420,188.462808612444,173.18459555824
"8138",478,88,390,187.674048753296,174.49471285192
"8139",482,84,398,194.952473225154,181.458091991797
"8140",487,92,395,196.679744848901,173.733419322735
"8141",464,79,385,194.758010661668,169.768714636727
"8142",482,79,403,191.263281388535,177.470560074889
"8143",468,75,393,200.071117138991,175.361113398246
"8144",495,90,405,202.184845388701,177.700944574937
"8145",490,89,401,189.474637390349,178.512492618659
"8146",482,91,391,193.415890368856,177.039524465388
"8147",489,78,411,190.418006167219,179.356309125115
"8148",479,85,394,200.610271238089,179.833253135398
"8149",490,84,406,192.560685833789,176.145825751599
"8150",482,86,396,194.685504623713,175.028211044355
"8151",485,84,401,199.76689591803,172.926272839747
"8152",494,87,407,194.857621021728,181.159951043891
"8153",498,87,411,188.67751276265,176.718270909023
"8154",486,88,398,192.987368562222,177.978411747681
"8155",479,77,402,203.269566895571,175.718656660426
"8156",476,83,393,193.995434024212,177.28429813181
"8157",485,86,399,201.454668249317,180.204169039188
"8158",489,84,405,199.225004406761,175.337256543036
"8159",467,79,388,199.665500230469,173.539903532431
"8160",475,80,395,193.630007950339,175.725656483848
"8161",491,92,399,187.720387692379,183.619077167446
"8162",487,79,408,187.522876322095,177.24027406644
"8163",493,83,410,186.51832583315,180.93549860481
"8164",482,83,399,183.675051044699,172.275935337282
"8165",471,80,391,190.37544777434,173.204892716451
"8166",470,83,387,193.623199810306,181.171088449971
"8167",503,91,412,193.039617527093,182.72904076317
"8168",486,80,406,202.45986770688,173.430636426562
"8169",475,79,396,191.304185252524,174.567193940091
"8170",469,81,388,199.177948105917,177.684027095673
"8171",483,89,394,186.170220273214,174.837549195915
"8172",507,87,420,191.194062071146,173.356992058541
"8173",491,89,402,196.890726518455,174.198293901563
"8174",484,91,393,185.905299040038,171.10861095147
"8175",479,87,392,192.012450445074,174.49341046375
"8176",481,87,394,202.814327035909,177.854657206697
"8177",491,81,410,197.546353329204,178.90497671695
"8178",484,88,396,186.145884634552,176.531075794021
"8179",496,85,411,193.766801644278,172.96829286036
"8180",486,85,401,197.482792725034,185.630221452011
"8181",481,69,412,196.662109466053,173.205313478773
"8182",487,79,408,206.16056265233,173.466136409183
"8183",475,90,385,200.52983794172,182.411058111136
"8184",487,88,399,192.369125555828,176.12786081197
"8185",477,78,399,190.046298249957,170.632275284026
"8186",472,85,387,191.601785098944,175.197607633687
"8187",482,80,402,202.88480653125,178.136755518663
"8188",477,89,388,191.997584853563,179.450666724126
"8189",487,89,398,179.026829532266,178.201661150225
"8190",485,83,402,206.717496060608,174.140602886629
"8191",484,86,398,193.030327419469,175.591725031143
"8192",479,92,387,200.686143318477,178.468399100651
"8193",475,85,390,194.002388994346,169.275723447317
"8194",473,80,393,184.207006212674,177.15162319414
"8195",487,85,402,190.204638416798,177.215412022905
"8196",472,87,385,205.659991272062,176.806271136506
"8197",490,79,411,186.18278221266,182.826103946643
"8198",503,92,411,182.64437869536,182.803078226842
"8199",492,89,403,190.353279427694,175.339400754526
"8200",477,87,390,182.348868709527,177.983170190198
"8201",472,81,391,207.925988852366,179.027915979899
"8202",482,90,392,196.607504884073,179.404630787852
"8203",490,83,407,191.060717342957,175.257246194626
"8204",500,88,412,198.013441717915,181.795683766938
"8205",479,90,389,180.710583245807,179.321705997377
"8206",482,75,407,211.020165299105,176.749290198644
"8207",493,96,397,188.721118460985,179.737643137104
"8208",480,79,401,198.812617537876,179.413423341028
"8209",470,81,389,197.237964593283,178.892637751365
"8210",467,76,391,196.234985690332,176.534852771702
"8211",482,87,395,197.967345488464,173.053053923375
"8212",478,82,396,198.63108982253,175.507356351834
"8213",490,87,403,200.00650575778,174.636019684834
"8214",473,74,399,200.320391214563,174.709815140111
"8215",483,78,405,198.367861315692,179.282507017978
"8216",485,87,398,202.880283186091,176.283991942557
"8217",499,87,412,182.033880850232,183.407288316584
"8218",486,87,399,194.235263525991,183.729663374234
"8219",487,90,397,189.121946946126,180.56061581966
"8220",478,86,392,201.009560492508,177.807462452001
"8221",469,83,386,201.827510551367,172.918270510578
"8222",463,76,387,190.73978131154,174.517683717043
"8223",478,83,395,210.52301937585,183.149138142623
"8224",479,80,399,194.614553527609,176.051346816591
"8225",485,84,401,198.209572537757,184.393865755806
"8226",476,86,390,199.980248953141,172.029258149021
"8227",491,86,405,197.098051268495,177.237133518519
"8228",479,83,396,193.795092410121,179.737568247007
"8229",498,89,409,194.162661580323,180.854497545539
"8230",489,79,410,209.425401257974,175.461772791336
"8231",475,79,396,192.811501484891,186.401966103915
"8232",476,83,393,202.575008829227,176.791772922743
"8233",494,89,405,196.270730341621,177.057306604228
"8234",474,82,392,206.296217473401,181.826361415952
"8235",483,93,390,200.665626628927,171.345571082871
"8236",484,78,406,190.778505002202,176.159127971131
"8237",488,80,408,198.142751866542,178.804980668054
"8238",481,83,398,201.26169818029,182.677920252405
"8239",497,94,403,175.143000266995,175.843953480755
"8240",472,83,389,202.325342350079,175.098692489597
"8241",490,87,403,195.245621442205,175.524391253875
"8242",473,81,392,202.246308309118,179.287623879219
"8243",493,88,405,201.876752484366,171.156703166089
"8244",489,91,398,199.436602941296,180.891328585459
"8245",480,82,398,180.625899144607,177.45487431606
"8246",493,88,405,189.044880362338,175.401346755364
"8247",475,79,396,193.077493261642,178.419816291994
"8248",475,77,398,192.017676831119,173.706043615285
"8249",481,83,398,204.792041328018,180.636027726144
"8250",487,87,400,181.767709941337,177.575267624373
"8251",481,81,400,193.688334664392,173.672922277632
"8252",488,82,406,197.672423233825,174.873807406861
"8253",494,86,408,195.048140645638,180.833847093801
"8254",481,94,387,189.266375915576,170.389875480268
"8255",483,77,406,190.869985853684,177.387637859899
"8256",471,76,395,204.355576992047,180.19341210536
"8257",501,86,415,183.247341109768,177.791181153891
"8258",492,83,409,189.689665052373,174.235446812726
"8259",489,89,400,199.338564661349,176.124060971207
"8260",494,86,408,201.126310706957,178.313751221875
"8261",475,77,398,189.35756053905,176.516439814489
"8262",492,91,401,195.180414632974,173.916106967871
"8263",499,88,411,196.533985350576,179.246906349874
"8264",493,94,399,193.648259992562,176.41013361688
"8265",477,85,392,193.933633496175,175.459613804823
"8266",505,94,411,203.412195025104,183.681480562383
"8267",483,82,401,205.48282437404,170.076097344965
"8268",488,86,402,181.68368813564,179.796365044004
"8269",494,89,405,203.019650243301,173.841965428368
"8270",505,95,410,191.178835997128,175.494411585573
"8271",481,88,393,202.230539130922,178.416209883002
"8272",483,80,403,197.937061212898,182.816595982852
"8273",505,89,416,201.12108352121,179.261906523032
"8274",494,86,408,205.473708946963,180.637400576739
"8275",485,83,402,190.932249076831,176.304755653784
"8276",488,84,404,183.703625988064,177.151827184017
"8277",478,83,395,199.218888765928,180.077952359741
"8278",492,88,404,193.376346821108,182.691534503028
"8279",467,83,384,211.049224553409,175.601446227948
"8280",498,94,404,183.012575200977,176.552697177552
"8281",490,76,414,192.72341228854,178.455306489246
"8282",482,80,402,193.807699512584,181.418744726026
"8283",475,97,378,204.568640935734,180.109235672551
"8284",490,89,401,202.705136394186,172.792508258294
"8285",476,90,386,192.487587067975,176.02920247079
"8286",496,89,407,188.254965104798,176.136401397967
"8287",481,84,397,187.126144124478,177.244572234468
"8288",494,83,411,198.973084215105,183.888314399286
"8289",489,90,399,201.273309848836,180.201436098054
"8290",478,90,388,198.130454355067,175.688442209539
"8291",472,92,380,189.435434431454,170.463400582973
"8292",479,86,393,198.289090278402,171.729583043189
"8293",485,91,394,191.844327690109,171.932646715
"8294",484,91,393,189.028029045647,176.348328126084
"8295",473,80,393,183.627607496693,170.680996840885
"8296",473,81,392,202.616403897988,177.647460580494
"8297",497,83,414,195.583910642363,177.470132800786
"8298",485,92,393,200.778806544465,171.6247115218
"8299",486,86,400,193.516846460615,178.812337669883
"8300",492,87,405,196.402063134195,177.574231256419
"8301",487,85,402,199.149709905872,177.40623106011
"8302",481,91,390,194.754409184879,176.220008815963
"8303",479,88,391,191.773123401427,178.671760543931
"8304",500,83,417,196.213065128415,180.928428826575
"8305",482,79,403,193.165781392561,174.368414692995
"8306",475,89,386,185.287552643835,184.220132891313
"8307",486,82,404,193.324945169146,178.866746277546
"8308",482,85,397,188.755548894028,177.471340113209
"8309",488,86,402,189.862764229354,172.387473971279
"8310",476,86,390,190.863760113698,168.093346184412
"8311",485,89,396,195.441569805781,172.873984082767
"8312",479,89,390,179.655974079379,173.911533103312
"8313",482,85,397,194.745761602504,173.891253952505
"8314",492,96,396,182.844566681925,173.343292867857
"8315",498,87,411,190.206751152889,175.746164272628
"8316",467,88,379,195.505953508432,175.072617425571
"8317",505,87,418,189.232126686628,175.378671480684
"8318",477,84,393,181.404562625743,173.818686924955
"8319",490,87,403,180.799881490563,174.83413669671
"8320",473,86,387,197.9536123732,180.589641473011
"8321",482,82,400,207.143047468355,172.27402982055
"8322",490,91,399,198.461087242433,176.105000690899
"8323",489,74,415,206.085886452537,179.147651048113
"8324",477,84,393,197.584720659775,175.972257576939
"8325",478,82,396,201.484903247988,178.373448546399
"8326",482,81,401,191.22894737825,179.726873059973
"8327",488,92,396,198.574742920318,182.175417269364
"8328",496,94,402,200.617141596501,173.534064818646
"8329",490,87,403,201.882655420309,178.210352490338
"8330",472,86,386,184.948276296359,179.696508352283
"8331",487,81,406,204.615007778461,178.338744381509
"8332",481,83,398,209.759172726697,173.860368969446
"8333",498,91,407,193.517854168016,175.082231972158
"8334",487,81,406,194.001329832539,177.438260578389
"8335",481,86,395,204.671963992314,180.338294657179
"8336",479,83,396,201.576272067803,178.455876457582
"8337",491,88,403,188.14937699006,178.230200119715
"8338",482,84,398,193.658350227389,180.028954703334
"8339",480,90,390,182.698328137611,180.270307306699
"8340",481,85,396,188.989172567206,174.799910738517
"8341",495,85,410,182.766779233277,177.078346344166
"8342",485,84,401,195.896679406611,179.127162117294
"8343",499,76,423,190.257046141449,175.38392761874
"8344",474,84,390,192.928013677886,169.939000643136
"8345",492,87,405,196.36442650911,175.735173105602
"8346",469,80,389,197.657675376361,175.773809953163
"8347",494,85,409,199.14040328011,178.651110026044
"8348",486,80,406,204.599539478097,179.886790411402
"8349",467,77,390,185.874404714862,182.389746758227
"8350",490,88,402,207.118301708092,179.801917050443
"8351",470,85,385,197.616004137512,174.077559737382
"8352",484,89,395,178.194725780675,177.781884771953
"8353",492,86,406,196.651498601622,175.950227267238
"8354",497,87,410,210.794753797395,181.280393081263
"8355",481,82,399,205.928251439335,175.519254082092
"8356",473,85,388,183.702987357574,176.568040482551
"8357",492,81,411,197.127983988643,177.095843889445
"8358",502,96,406,193.336621643115,179.407503928681
"8359",478,85,393,202.161984756718,175.620319122599
"8360",469,87,382,192.753848005157,175.768373408115
"8361",478,87,391,193.118939838308,174.60288605791
"8362",489,85,404,198.333096798439,177.95650028552
"8363",474,88,386,196.786940584167,178.680052206146
"8364",481,86,395,197.494433187802,176.399485845678
"8365",458,79,379,191.954570741098,180.075422547029
"8366",472,93,379,196.164494750144,174.20222295624
"8367",494,81,413,194.61344617491,180.869001425177
"8368",488,92,396,184.968635859582,175.08648310874
"8369",494,96,398,190.091403214046,179.519754514697
"8370",487,84,403,192.379566106773,179.648119016928
"8371",487,91,396,207.899457245329,171.607586116903
"8372",473,84,389,188.297997147717,172.635770426003
"8373",503,92,411,195.414565403256,177.568007440958
"8374",489,83,406,197.483892537488,178.482845549311
"8375",502,97,405,186.43264361943,181.135288679784
"8376",480,84,396,188.486459696658,179.690859674893
"8377",472,87,385,184.101625418792,172.590147485749
"8378",468,79,389,190.956196972444,183.52275867258
"8379",470,84,386,198.032711811946,180.173382539004
"8380",474,80,394,185.79108350404,177.961837172956
"8381",502,89,413,195.27145504773,173.314682502797
"8382",469,88,381,202.298289775007,171.482103122221
"8383",485,79,406,195.291351709964,181.417361016297
"8384",489,102,387,188.301758666089,175.177420995025
"8385",493,90,403,179.350065670695,177.542696590073
"8386",476,84,392,200.050249282335,173.896030886703
"8387",473,79,394,202.766207011102,175.659299374027
"8388",496,90,406,197.046857693758,180.080568851761
"8389",478,85,393,203.614229463891,175.84638886576
"8390",483,92,391,196.965548777725,180.510767194557
"8391",496,84,412,204.514988451311,176.669744835418
"8392",481,91,390,184.608126246934,181.502507779241
"8393",497,87,410,190.50171868291,182.091628681576
"8394",496,83,413,182.188453717468,172.559409722367
"8395",473,88,385,197.294630599412,174.017729099545
"8396",490,86,404,194.916283847867,175.246983779614
"8397",483,82,401,197.68571418451,181.083448820641
"8398",502,87,415,200.898316797636,185.801206083548
"8399",480,81,399,194.834737672893,179.595935560007
"8400",488,90,398,204.293883530958,173.775030674135
"8401",486,95,391,184.745031417329,174.756598264538
"8402",503,84,419,204.359753646402,180.542053159733
"8403",505,93,412,197.674657194756,174.736411252409
"8404",481,82,399,186.505331986943,182.875803657914
"8405",483,82,401,196.901568830085,175.885667695978
"8406",470,84,386,196.064081509589,175.756893146457
"8407",490,86,404,189.142858674234,181.609055035054
"8408",491,86,405,195.64064049841,178.771590706407
"8409",494,78,416,191.821940424706,174.903526962283
"8410",489,82,407,193.446777178438,178.831686730629
"8411",489,90,399,198.580475208054,175.857717976292
"8412",492,74,418,198.461289266298,180.230040564713
"8413",487,84,403,191.972826067633,178.28121535617
"8414",489,83,406,199.338783782158,180.927096662318
"8415",485,85,400,190.341077250235,180.83370511499
"8416",464,85,379,182.389319902387,167.99806691603
"8417",490,84,406,195.625813798325,176.62414305096
"8418",472,90,382,197.220661881934,175.572293260083
"8419",473,86,387,200.717746154876,176.695514435139
"8420",492,91,401,206.619864315081,181.969473723623
"8421",483,89,394,194.297566202881,177.186483130798
"8422",508,83,425,190.352761573598,182.735001118345
"8423",490,82,408,200.701023260736,172.600268941573
"8424",487,87,400,196.788303143809,176.371346549224
"8425",471,85,386,197.423645429662,180.250302125927
"8426",495,85,410,186.567925830096,179.757787856777
"8427",485,92,393,185.433276616048,174.719299976142
"8428",483,92,391,201.706866921001,180.23021501615
"8429",490,88,402,197.444293912711,181.955815495053
"8430",496,78,418,188.590275001554,171.753359188217
"8431",480,85,395,196.974609418838,176.345644324731
"8432",484,86,398,195.999110897087,175.912661256222
"8433",482,86,396,193.743075142946,172.004271689829
"8434",490,85,405,196.705048221971,173.934924752813
"8435",469,89,380,200.877647522276,173.634238382218
"8436",484,93,391,194.146387349875,175.885478682954
"8437",494,92,402,185.068841958316,174.818955448645
"8438",481,87,394,185.731954088528,174.44253385666
"8439",493,88,405,180.527936540841,169.539417668666
"8440",504,92,412,194.579298559216,179.06974036275
"8441",478,81,397,194.499115348998,181.94736115701
"8442",477,75,402,191.809342326315,176.65200481337
"8443",482,80,402,197.711688924695,179.055753541398
"8444",481,85,396,215.0409550164,167.468923302759
"8445",477,89,388,195.4456172748,171.468060412868
"8446",495,93,402,193.796510019585,177.021913973613
"8447",488,92,396,181.098584385367,176.008201097052
"8448",497,91,406,205.151843975266,179.946366172584
"8449",490,89,401,201.20485210543,178.557199357767
"8450",478,81,397,204.933227681512,178.088500673425
"8451",492,85,407,193.551759069695,183.553716426269
"8452",470,82,388,194.949218847134,171.738631854782
"8453",490,87,403,195.769221228717,176.981270555612
"8454",466,84,382,190.843074428672,181.457222729718
"8455",481,89,392,187.709025844744,178.905804563987
"8456",478,82,396,193.529576390387,179.518762696937
"8457",491,85,406,211.705840175438,173.718168115
"8458",478,83,395,200.168057755475,179.073218031561
"8459",491,79,412,189.15496455649,172.638600548882
"8460",471,86,385,193.49088084423,176.919300536719
"8461",478,84,394,195.434836697747,169.892735151651
"8462",487,81,406,194.167170423588,176.961099101517
"8463",473,82,391,200.58511418714,178.090167515998
"8464",470,88,382,196.541558982459,168.928626945379
"8465",476,83,393,213.371902510694,181.773493005073
"8466",492,85,407,204.217080663598,178.519280321413
"8467",473,88,385,185.401598866397,175.292980165921
"8468",484,77,407,208.483861187017,174.373887196637
"8469",494,83,411,202.476988138424,179.138906140117
"8470",484,86,398,193.468619311194,177.92187583074
"8471",506,89,417,205.899707602216,177.691764209573
"8472",493,89,404,197.451615599729,175.027918102458
"8473",479,89,390,197.397428552513,183.339464197553
"8474",474,78,396,199.88904045806,179.616413726776
"8475",473,84,389,203.945111497964,175.983511000318
"8476",487,88,399,189.166248886024,177.228984047281
"8477",480,86,394,190.938364123291,179.192652944009
"8478",483,83,400,199.906710292894,174.675183436872
"8479",475,77,398,188.21122642132,178.491708511866
"8480",493,86,407,193.141077033622,181.641480611067
"8481",484,87,397,193.047767585584,177.628362145605
"8482",486,89,397,195.468633940572,175.390687609599
"8483",477,85,392,195.072610317848,178.807800029872
"8484",470,81,389,175.646537255352,171.886750803199
"8485",493,90,403,193.941537969296,175.091412486119
"8486",496,84,412,197.232547743443,178.079330869371
"8487",495,89,406,199.297832705928,176.411991920854
"8488",500,86,414,205.615940720214,178.77932312846
"8489",476,86,390,193.622913909413,178.250200891984
"8490",488,86,402,195.819353230133,176.582094826693
"8491",471,84,387,186.034352088761,171.708684076445
"8492",495,90,405,191.320518828105,177.509705731458
"8493",474,82,392,184.822423004804,176.358977364618
"8494",494,89,405,190.437599925646,176.688245976859
"8495",488,79,409,198.810108104344,175.882085470744
"8496",488,87,401,193.619830096055,180.098986618054
"8497",475,88,387,196.705386448137,177.691623038729
"8498",481,88,393,202.517875887399,173.90633874647
"8499",492,90,402,191.109880577048,178.612681343484
"8500",504,87,417,183.652386103658,174.818978281746
"8501",487,90,397,194.485300701205,175.975748720213
"8502",481,82,399,183.444126077672,174.950916282811
"8503",492,92,400,200.191751933211,177.394058468277
"8504",488,84,404,199.988420725841,179.130790869542
"8505",498,92,406,196.777815609418,176.557861374642
"8506",488,87,401,192.504038983407,177.582898299631
"8507",478,77,401,195.368537617388,173.533812099545
"8508",486,85,401,184.726429202648,179.147838532772
"8509",486,88,398,182.833186178504,179.494320866855
"8510",489,90,399,199.226438722364,169.893182751046
"8511",482,88,394,191.648762796089,181.938357223745
"8512",498,87,411,205.809097112169,178.340234334499
"8513",473,84,389,197.251664534303,176.885122705061
"8514",494,80,414,195.606390100344,178.483116629954
"8515",476,81,395,192.894203421119,174.178775412913
"8516",489,91,398,188.954692216202,169.949597068132
"8517",491,84,407,188.979770800376,175.953148800627
"8518",491,81,410,189.940129400581,174.141902921741
"8519",464,83,381,199.371432528621,177.964707174059
"8520",496,86,410,192.227085957791,179.931503253426
"8521",470,85,385,192.253418961304,177.23400032806
"8522",479,86,393,191.409108363006,178.016860809012
"8523",487,86,401,195.981465643891,179.489486503873
"8524",497,90,407,185.689262012135,174.911611171301
"8525",486,95,391,199.783982940754,173.452576984357
"8526",492,95,397,184.992778567546,178.811280383565
"8527",477,82,395,190.509528130846,184.955368523692
"8528",477,91,386,188.129611153006,175.552810665805
"8529",479,87,392,189.313007495295,185.637153163182
"8530",495,95,400,184.843223080747,174.62591460807
"8531",489,98,391,196.500532638506,168.663870036957
"8532",489,86,403,193.265456827306,177.130506400264
"8533",488,86,402,194.123757943946,172.53929694713
"8534",480,81,399,212.709776714826,179.780846767539
"8535",481,94,387,205.0902918885,177.98048608216
"8536",483,75,408,214.199261469919,175.922358048682
"8537",486,95,391,192.588079670219,171.337611167253
"8538",478,85,393,202.649197703214,175.907530079045
"8539",498,86,412,205.23860285527,175.453757959181
"8540",477,84,393,174.67681136801,173.690154880196
"8541",493,83,410,188.600695979109,176.967613968585
"8542",476,82,394,193.827834565968,181.373981409664
"8543",489,79,410,201.87298180783,174.579217500157
"8544",489,84,405,194.821355197457,174.878376482418
"8545",489,89,400,195.628380397711,177.731150635354
"8546",479,90,389,191.475121645157,181.646052043227
"8547",474,90,384,194.279335494429,173.382675540591
"8548",480,82,398,188.838112096552,177.352304434578
"8549",496,84,412,195.496868230836,172.693264943307
"8550",495,86,409,186.48390695688,170.149790732437
"8551",495,85,410,200.197065044038,178.335578499226
"8552",504,94,410,186.154664634096,177.518442565479
"8553",499,96,403,192.107282491968,172.564622396456
"8554",482,89,393,205.744232972501,175.765376909035
"8555",488,87,401,207.880324803126,174.650400684871
"8556",473,84,389,192.454538638117,182.952027379129
"8557",490,86,404,185.787530993184,172.17350217428
"8558",477,84,393,188.309997681532,175.878913864138
"8559",482,86,396,187.102078043679,179.80709516449
"8560",489,85,404,190.767031647803,181.342295018708
"8561",477,79,398,192.39060832602,171.57922770478
"8562",476,89,387,184.714038979307,178.643880877486
"8563",494,84,410,207.002450166802,176.987499255582
"8564",479,87,392,202.539740739037,179.020143225923
"8565",486,80,406,202.693596275307,174.57828450166
"8566",482,92,390,197.032155524996,175.518185747392
"8567",487,88,399,198.913728160265,176.005501073927
"8568",467,83,384,196.016260013664,179.166521798238
"8569",482,76,406,186.718552819676,178.511139286464
"8570",491,93,398,197.035681535258,178.402926536001
"8571",480,82,398,187.489658032831,181.890279731316
"8572",489,87,402,197.805974536775,173.85824863734
"8573",500,93,407,194.053152590947,179.66525340102
"8574",480,85,395,186.924171645005,172.077506653894
"8575",482,86,396,190.748290341674,171.515637313309
"8576",482,81,401,202.983028852191,175.821657076308
"8577",478,84,394,198.320551233459,170.259825709974
"8578",492,88,404,180.611130851844,174.613240107298
"8579",488,87,401,189.471476189392,178.789212447683
"8580",483,89,394,195.528428256778,178.214944111456
"8581",489,87,402,199.677689347002,170.588380890652
"8582",492,82,410,179.496588571857,175.574509901438
"8583",495,86,409,194.249817659431,169.062822826349
"8584",492,85,407,191.862772831261,185.401108976846
"8585",484,84,400,203.553991637458,175.693930649054
"8586",486,91,395,195.916804215073,175.067134375615
"8587",479,84,395,192.116178610958,175.511356938224
"8588",475,84,391,203.245168175404,171.352099423989
"8589",499,83,416,181.224956033488,180.10704482247
"8590",485,91,394,202.296346581062,181.239375323673
"8591",485,88,397,202.213989661802,174.907418028972
"8592",478,81,397,191.828920577749,179.098930124638
"8593",480,80,400,180.673125357132,175.145254751746
"8594",486,93,393,194.045078430158,179.007850290746
"8595",489,86,403,196.609187175365,172.404316091202
"8596",482,85,397,196.842123216083,172.874575841802
"8597",476,82,394,189.957782545006,175.494978894412
"8598",488,84,404,197.70478649555,169.708894034691
"8599",481,99,382,187.148542353522,179.139153964104
"8600",479,82,397,194.691310075682,177.205913445898
"8601",477,83,394,194.307087507689,168.750320149556
"8602",482,79,403,190.636254603569,175.332760216558
"8603",489,92,397,205.26762424541,171.021205265561
"8604",483,88,395,187.825921553299,173.917107693641
"8605",493,88,405,196.701965014628,169.011954952511
"8606",482,89,393,190.243020971905,179.906108783021
"8607",459,79,380,205.49336891274,184.129092421479
"8608",478,94,384,208.055135359954,175.850001210349
"8609",477,79,398,202.255634410637,173.367869001623
"8610",489,87,402,197.568248343121,182.18614372121
"8611",480,90,390,198.73675601906,173.893118558682
"8612",477,85,392,188.034866237357,177.871703642352
"8613",477,87,390,186.894652954834,177.874561271415
"8614",496,81,415,197.759904467237,178.829699917806
"8615",475,88,387,193.854985074996,171.040308440026
"8616",483,84,399,202.038323405443,181.240130765844
"8617",486,85,401,211.629811931287,179.321164858031
"8618",481,83,398,200.890635216945,181.207580864009
"8619",496,83,413,198.75139850646,172.850421468915
"8620",483,87,396,189.692536798964,169.851013362874
"8621",479,80,399,201.792374014861,182.458914931909
"8622",476,78,398,202.568522243027,173.910445585143
"8623",475,91,384,194.955548181917,174.316548766874
"8624",496,84,412,195.416989839998,174.884859875999
"8625",500,89,411,189.489488520304,173.983976788028
"8626",494,87,407,191.268489896744,172.117831290675
"8627",482,80,402,203.610701003938,181.182699767759
"8628",488,94,394,190.504553742975,178.402714936376
"8629",482,84,398,203.776058841554,177.665905010945
"8630",487,92,395,197.25675336457,180.939210317879
"8631",499,91,408,195.441415331037,174.917244790203
"8632",484,92,392,201.768665842176,180.603460870995
"8633",473,85,388,180.443450907337,181.028623442856
"8634",503,88,415,187.866804963898,174.769703153971
"8635",494,90,404,198.185225288263,176.393903266392
"8636",488,87,401,196.152240311988,178.286345906747
"8637",490,93,397,182.948391715913,175.672950590489
"8638",484,83,401,182.338640382217,175.140497248655
"8639",480,81,399,183.611482766204,180.946223216661
"8640",459,86,373,194.95107176841,171.664216598677
"8641",472,84,388,196.574309077883,176.646763791349
"8642",503,86,417,197.727382951317,179.027875497903
"8643",474,82,392,192.56334683115,170.65648149714
"8644",468,85,383,188.110415616442,178.442833109305
"8645",481,92,389,201.156060585611,176.992517965518
"8646",481,79,402,200.741139247477,169.4310441102
"8647",483,84,399,198.560323507962,172.907461264436
"8648",476,85,391,203.460624388396,172.744276868122
"8649",481,82,399,192.933030296736,172.818654185741
"8650",499,103,396,193.54646114271,172.147232148242
"8651",499,85,414,189.166802873363,173.679739144536
"8652",488,93,395,208.745736347821,182.842822611775
"8653",488,83,405,186.061288527499,180.698798236807
"8654",500,86,414,191.68116979612,173.425162121479
"8655",468,83,385,195.022221897916,178.165178408313
"8656",480,91,389,193.346825911802,175.377177358089
"8657",483,87,396,182.675604081833,178.798282731425
"8658",479,82,397,190.853572572116,181.796560219342
"8659",482,85,397,200.587603830208,175.429096176107
"8660",484,82,402,190.436690846636,170.414999846845
"8661",489,87,402,206.016521911222,179.941087015544
"8662",490,84,406,193.750588298628,176.416696137616
"8663",495,84,411,206.305242792803,179.401587853935
"8664",474,85,389,202.719265753451,169.3568546918
"8665",487,87,400,188.22486855181,180.617244976721
"8666",466,87,379,189.584741157487,174.950495657688
"8667",499,91,408,192.17513209089,171.836178184255
"8668",478,87,391,197.21204622115,176.215338443765
"8669",498,90,408,194.028565013334,176.846390174574
"8670",475,90,385,188.548584905143,175.814512602163
"8671",482,80,402,191.367893376605,178.267860816459
"8672",475,82,393,194.807979112633,174.167253761772
"8673",488,89,399,199.770017376801,178.628410456279
"8674",493,80,413,208.940558926774,176.564573865711
"8675",480,86,394,187.683388355838,182.427020827175
"8676",473,83,390,197.2819610235,172.146017633466
"8677",508,90,418,201.467876204388,171.991781500621
"8678",483,93,390,196.612919760633,177.573394637219
"8679",489,81,408,186.939998093615,177.878056413997
"8680",503,94,409,197.024373940159,176.704975011635
"8681",489,90,399,199.786633125654,174.962914724941
"8682",495,84,411,201.172251255626,182.518361802024
"8683",498,81,417,197.733952410107,177.506866767358
"8684",497,86,411,188.113554856646,177.077680771704
"8685",483,92,391,193.13741404428,168.239501879181
"8686",468,91,377,203.518086195759,175.178411611215
"8687",480,80,400,204.262127563174,178.882652174033
"8688",502,82,420,200.659056221679,179.493897990313
"8689",502,95,407,201.635074993375,174.921169118553
"8690",496,80,416,194.495066041739,172.548899258972
"8691",492,85,407,193.572933455682,172.85729111127
"8692",496,93,403,198.108926852773,176.910314753613
"8693",502,90,412,200.702618533914,179.178934271374
"8694",502,87,415,190.087456619185,172.01609273167
"8695",469,86,383,197.064999805229,178.05398506517
"8696",484,78,406,204.00918570145,173.229226774837
"8697",491,89,402,202.558206915385,180.999227156788
"8698",489,83,406,199.342820721184,178.306380797866
"8699",478,85,393,197.887202825359,175.00463212492
"8700",487,81,406,198.399361306733,175.388439491995
"8701",482,85,397,192.013564687021,176.179129116687
"8702",500,98,402,206.541566510953,178.311589364732
"8703",470,84,386,191.622649465094,172.310015579608
"8704",493,87,406,194.271675428719,179.088353312254
"8705",479,85,394,184.507900694869,180.95976790629
"8706",472,83,389,197.250136405311,172.449293136921
"8707",496,81,415,205.196673222126,176.310781429093
"8708",507,93,414,190.453157284411,176.512991497487
"8709",484,81,403,200.614768517236,180.018509278067
"8710",483,90,393,189.5238972063,169.202544369828
"8711",481,80,401,191.204828990341,178.177961747275
"8712",477,83,394,207.230593528677,181.445278497317
"8713",480,88,392,198.655420215918,176.330378617746
"8714",481,84,397,199.942067940882,183.048433539396
"8715",487,84,403,203.192323999433,179.048414735549
"8716",493,87,406,195.6334265806,174.873621847449
"8717",490,80,410,183.79455967784,173.888749830819
"8718",487,85,402,195.411734037676,173.38571956488
"8719",483,82,401,198.067700200396,176.580260610695
"8720",501,76,425,191.785247667454,183.465374696973
"8721",501,92,409,196.005696850621,175.733843620002
"8722",471,77,394,196.602724138068,172.487687308634
"8723",491,84,407,195.180916327431,172.534294020585
"8724",496,89,407,202.689668879965,180.755395988431
"8725",480,82,398,194.859898094881,173.755912853822
"8726",467,78,389,195.143480766028,174.088365968535
"8727",478,96,382,187.227675166174,172.138875216645
"8728",481,92,389,188.677030661748,174.68307773218
"8729",468,86,382,203.938119214817,178.643432357924
"8730",471,86,385,194.625164951707,171.177535686557
"8731",492,83,409,191.189318311288,180.101759559381
"8732",504,82,422,197.70425500623,180.954585429672
"8733",497,85,412,195.545292881337,174.831397562385
"8734",477,87,390,178.372033365169,172.406119660155
"8735",474,85,389,205.180726279184,175.570046681152
"8736",488,89,399,185.363402684244,167.994365343989
"8737",484,81,403,201.50338176219,173.118515796076
"8738",476,84,392,203.321728933307,178.735549321748
"8739",485,83,402,198.215842202144,178.692334230716
"8740",478,81,397,186.758817652083,178.039946111649
"8741",482,88,394,175.561173200012,170.977196775382
"8742",486,93,393,206.386470662207,180.11201046093
"8743",496,89,407,193.548700518841,178.422311129072
"8744",494,83,411,196.460017745945,175.551055534541
"8745",482,79,403,199.826670961381,180.659093044949
"8746",472,88,384,194.961327614756,177.571021488127
"8747",469,86,383,199.885728722325,179.29113614797
"8748",478,85,393,196.105398927572,174.800730756754
"8749",485,83,402,192.01705900769,174.121728638147
"8750",514,89,425,188.71185260879,171.521031253238
"8751",496,89,407,193.654481882259,183.526363524848
"8752",479,88,391,185.509350164698,170.276712538025
"8753",496,89,407,201.83117152153,176.807012731248
"8754",512,99,413,198.258640242538,172.712316536792
"8755",473,83,390,193.076868111063,177.928810231877
"8756",475,84,391,199.065120496245,181.900746643101
"8757",482,81,401,197.651126853808,178.049346555952
"8758",480,92,388,197.415827538979,175.821717209412
"8759",476,89,387,207.269982745296,178.301691553202
"8760",488,85,403,190.468470013109,176.50059122465
"8761",478,82,396,201.559321967355,180.854719808704
"8762",490,91,399,189.179984830825,174.246270939649
"8763",487,83,404,198.43704552913,168.216371617792
"8764",479,82,397,182.321998197994,178.999866506488
"8765",481,87,394,206.09785553701,168.697375990434
"8766",494,87,407,196.581301399287,173.545964106431
"8767",482,88,394,181.102090806946,174.916906648738
"8768",499,85,414,195.899563224713,175.719137293579
"8769",501,85,416,202.772130686681,176.481012260789
"8770",507,95,412,185.440685833843,176.480290806276
"8771",496,93,403,183.89995706693,182.843560169757
"8772",503,91,412,200.282335987405,173.886951439223
"8773",486,85,401,196.481258980934,176.864769520574
"8774",481,85,396,214.109680106051,171.247865736368
"8775",493,89,404,191.493721343809,174.527350159228
"8776",498,85,413,199.231235120366,182.518920750791
"8777",495,88,407,190.096404261815,172.100488889474
"8778",492,95,397,190.71755178354,175.413486667307
"8779",472,78,394,203.307978139738,177.317429350708
"8780",492,88,404,191.890106683444,177.96346402207
"8781",495,93,402,192.135709904263,172.412699508144
"8782",493,92,401,199.254096025928,181.010927281619
"8783",490,92,398,183.77212400655,178.232041330905
"8784",480,89,391,191.006833070216,180.762618314228
"8785",477,86,391,197.753733843967,170.794681005212
"8786",472,81,391,201.125933478817,172.654454601994
"8787",473,86,387,184.889666308062,176.164211316248
"8788",487,87,400,205.824789769403,178.084339675276
"8789",480,77,403,201.816804824009,174.600488839896
"8790",500,92,408,200.249924163619,181.746653145541
"8791",489,90,399,191.704092242129,175.728184736832
"8792",507,93,414,188.910580021059,168.494234824298
"8793",495,79,416,204.422446362686,186.368053773811
"8794",486,93,393,195.053473116403,172.965489136927
"8795",486,91,395,201.206964784344,172.593194969685
"8796",492,86,406,199.389447248255,174.674226996142
"8797",465,86,379,202.695239255721,175.830926916872
"8798",470,85,385,195.706074227602,174.652806634611
"8799",497,88,409,200.630543623281,174.943590145543
"8800",490,82,408,203.921796307662,176.708604984052
"8801",478,88,390,199.280665670851,182.916960602271
"8802",469,85,384,208.988356644275,171.471667414033
"8803",493,91,402,201.397454774422,177.580406600272
"8804",487,79,408,198.074970645554,174.755624665526
"8805",467,75,392,194.097303820252,175.906664551152
"8806",499,92,407,186.183497368994,180.693582137554
"8807",493,87,406,198.852507045467,178.596140439687
"8808",477,85,392,192.738003855504,178.317764592348
"8809",468,82,386,194.893918898647,175.079874105949
"8810",481,84,397,187.81309157855,176.499380446689
"8811",496,92,404,195.188058525028,180.697728925512
"8812",483,88,395,202.649280069349,178.776306499363
"8813",475,78,397,190.020093155516,168.55569989193
"8814",490,91,399,186.203024267732,182.493442412668
"8815",478,86,392,184.153384722407,174.277443646875
"8816",499,82,417,202.02532117511,175.995203523989
"8817",469,79,390,177.123977459031,182.123542242751
"8818",488,89,399,189.564904098571,176.011062557021
"8819",482,86,396,203.265959908247,178.22734964493
"8820",486,86,400,189.287883951811,180.350096691788
"8821",485,89,396,191.8574810913,177.157596952764
"8822",493,89,404,194.660903469917,178.519819132913
"8823",477,83,394,198.15806203235,171.631029167677
"8824",470,86,384,191.648819281704,175.195787934571
"8825",492,92,400,200.499073972854,178.214382939696
"8826",501,97,404,197.99281615209,174.234102773836
"8827",493,85,408,182.208585822347,183.119160142153
"8828",505,91,414,192.801263742468,175.47793253601
"8829",492,89,403,192.700415641173,179.933630086085
"8830",475,83,392,198.218287842034,173.897830318487
"8831",492,91,401,193.945792350793,171.44840442685
"8832",485,90,395,201.762987464711,177.214279199243
"8833",476,79,397,196.733850276683,175.642593930358
"8834",480,86,394,182.73662474386,186.02147393632
"8835",488,84,404,206.243116505809,180.553587112872
"8836",473,85,388,180.758899097647,174.226683734143
"8837",492,85,407,199.998466099875,178.133990236343
"8838",476,81,395,195.285232564711,175.627351593193
"8839",474,81,393,172.072590103417,177.693431578245
"8840",477,87,390,200.278876579336,172.568037066915
"8841",480,78,402,189.784529746003,172.732230217418
"8842",484,83,401,185.268180888338,175.853569096113
"8843",491,88,403,198.887352170188,178.557299825366
"8844",481,88,393,188.536893416291,181.138616503402
"8845",477,89,388,199.796015411757,178.964795649816
"8846",488,78,410,199.358931294924,179.522476839257
"8847",493,93,400,197.050916315873,177.237100460362
"8848",498,88,410,199.356020697927,181.275439311787
"8849",491,85,406,184.663953202556,172.980056764093
"8850",484,87,397,186.870378522146,170.039260374107
"8851",486,90,396,203.425523967638,175.689185104522
"8852",485,90,395,182.168526666267,186.630571947926
"8853",485,85,400,193.886009461803,177.580063250475
"8854",478,82,396,207.540922500695,172.425635567866
"8855",491,98,393,206.076706830954,172.481789412551
"8856",475,89,386,198.562957985131,173.911639056199
"8857",481,87,394,193.162711173814,182.848618397388
"8858",489,85,404,190.222882094582,184.130052330091
"8859",477,79,398,200.097039711075,176.857702673677
"8860",481,84,397,208.999544942183,177.370726583057
"8861",474,78,396,195.102989196799,179.753656924259
"8862",483,87,396,195.245014549672,173.966316383175
"8863",496,95,401,191.270458710667,171.796905710344
"8864",489,83,406,200.638517964079,177.975406091182
"8865",465,88,377,189.360598317487,172.70443497586
"8866",484,89,395,183.004970428083,172.857391093885
"8867",485,93,392,198.365742308682,178.597514390388
"8868",482,78,404,217.745506821648,174.542623971653
"8869",489,93,396,199.988689338748,174.275394437932
"8870",477,86,391,202.991881797612,182.831016011166
"8871",482,86,396,192.595190638249,171.79229888117
"8872",478,84,394,194.079978024327,176.983331451787
"8873",494,90,404,193.105822834639,175.427559907504
"8874",481,89,392,202.435716554327,171.213612500743
"8875",471,83,388,182.11995223055,178.109050585561
"8876",497,90,407,195.524603574134,172.880228249076
"8877",490,78,412,181.388944951073,181.837360092119
"8878",487,84,403,210.009154302265,177.345253360258
"8879",486,84,402,207.467956506706,177.732881918481
"8880",509,92,417,198.183448037574,169.929003247815
"8881",483,85,398,207.134463213458,173.488765303762
"8882",473,82,391,200.556321519551,181.213487335286
"8883",490,87,403,194.992355506414,179.548526410272
"8884",492,91,401,195.642749864701,173.678907990552
"8885",491,82,409,192.972717995982,175.585298944106
"8886",489,93,396,186.267447759644,177.235124136105
"8887",483,82,401,192.209529060188,181.137048917855
"8888",479,89,390,199.645598565049,181.47512650619
"8889",488,90,398,202.103485813838,179.463007474369
"8890",477,77,400,195.892987610777,176.996716724615
"8891",476,88,388,187.454923643691,180.109373591014
"8892",498,91,407,185.530156172174,177.96267490332
"8893",482,84,398,203.393394577396,175.927585752693
"8894",493,80,413,202.441561862664,177.239307665035
"8895",486,86,400,199.607195626796,176.22913906468
"8896",470,84,386,189.57214691968,176.090852301869
"8897",471,79,392,196.994150766955,182.710579724059
"8898",477,86,391,191.134943672324,173.443548278138
"8899",473,77,396,199.08935130334,178.32011390635
"8900",496,88,408,188.518023091692,175.867281329148
"8901",486,93,393,196.15174357246,176.586054842041
"8902",469,85,384,181.445663004151,175.351071819562
"8903",503,93,410,213.253597350241,172.463637617563
"8904",488,85,403,192.441829562374,179.096594194881
"8905",489,87,402,186.04458272881,176.489300358344
"8906",489,83,406,198.144960418513,178.594848654993
"8907",482,87,395,196.426261212588,172.14433292352
"8908",476,83,393,206.971311208062,177.295568656357
"8909",486,87,399,204.970184348064,175.627991027579
"8910",472,85,387,195.186962395857,168.425082325037
"8911",484,83,401,178.848566317061,176.154601389508
"8912",482,76,406,191.740967358027,177.504433820592
"8913",488,100,388,199.99034533638,179.982563002336
"8914",487,87,400,194.955529674628,174.861690781247
"8915",511,91,420,197.575836460598,173.785142440231
"8916",476,84,392,192.020840682886,169.292057511045
"8917",498,84,414,204.736520675899,175.659030023455
"8918",492,78,414,198.346422204211,173.682432360107
"8919",483,78,405,194.407603418736,174.943607783086
"8920",486,82,404,202.767647459127,177.784562810255
"8921",484,83,401,192.467833945235,180.045322430771
"8922",487,79,408,204.986720077957,172.26420449883
"8923",493,84,409,205.985627690758,173.50702983839
"8924",484,93,391,192.187398008807,173.423312147102
"8925",471,86,385,188.143639198496,176.222960261701
"8926",471,83,388,207.603974264719,176.836672216205
"8927",477,89,388,193.989600733216,172.068159831973
"8928",476,80,396,195.746743117658,179.311851828414
"8929",503,94,409,194.45987027279,184.183890849009
"8930",490,82,408,200.748608957566,174.521761022857
"8931",501,93,408,191.377985145842,174.146758100313
"8932",492,79,413,207.044464489397,173.189912586017
"8933",487,90,397,195.286632721315,180.91193489258
"8934",473,84,389,189.971282296323,169.569603247873
"8935",475,90,385,194.287518073244,175.250804339214
"8936",486,82,404,186.0464989796,174.780609789925
"8937",506,91,415,199.653204783199,175.411243529779
"8938",486,81,405,206.14656744458,176.912117476365
"8939",484,87,397,192.132301017736,177.591290856263
"8940",494,83,411,192.243227062927,177.513320081895
"8941",495,90,405,201.104777970495,172.053222903143
"8942",484,85,399,198.387178992254,179.579926244073
"8943",469,80,389,200.895866948045,173.352717924328
"8944",481,84,397,202.755613589533,172.10907860487
"8945",492,86,406,191.399606242007,176.624897984026
"8946",488,88,400,199.240150628155,180.817112227872
"8947",483,84,399,202.825594626569,179.743412547133
"8948",474,87,387,176.928826433339,176.558232797649
"8949",487,84,403,192.505672636997,176.744571029964
"8950",485,87,398,188.070327979346,166.101074017042
"8951",476,83,393,203.371971118772,179.782669925488
"8952",478,79,399,203.497832489909,174.763711162939
"8953",480,80,400,183.985930509958,178.928329263472
"8954",483,80,403,202.863587718365,177.232069261845
"8955",464,80,384,215.439828948195,179.142605861047
"8956",493,88,405,190.246558250522,179.974687378582
"8957",485,90,395,204.154743527026,178.275035774501
"8958",494,90,404,181.958930934502,174.48360340524
"8959",483,76,407,200.514998123005,175.198228954102
"8960",492,90,402,193.183480661472,171.971325998764
"8961",505,95,410,193.768616796537,176.183397993669
"8962",481,82,399,195.885627725069,178.847654083052
"8963",478,88,390,192.687376534905,175.747337783664
"8964",484,85,399,201.232111843582,171.081134198087
"8965",504,88,416,200.665424849703,179.959932702632
"8966",478,88,390,181.778096654056,175.717656385893
"8967",481,79,402,200.851047040043,173.920057307481
"8968",478,81,397,207.398951071182,176.697623389704
"8969",487,77,410,200.291893973287,177.495000414002
"8970",497,88,409,200.585227768951,179.220856693882
"8971",496,84,412,203.239940762287,176.642177143907
"8972",483,81,402,189.086301631011,177.823251767813
"8973",472,75,397,188.787694272792,181.395903998388
"8974",473,87,386,192.850824723417,181.988511313308
"8975",489,87,402,191.759218985954,170.776582526514
"8976",482,85,397,199.187544429237,175.82989730015
"8977",477,81,396,186.37607290043,179.539900895063
"8978",484,88,396,188.221797027269,171.261434068535
"8979",464,87,377,194.099054643221,178.581961224352
"8980",479,80,399,183.133729355612,175.497600310119
"8981",494,95,399,203.000724213181,175.284593879908
"8982",472,82,390,186.624363103034,169.604057984344
"8983",519,94,425,200.065172283445,180.260225942527
"8984",487,86,401,190.855009464438,178.956526801637
"8985",473,89,384,208.041533598247,175.43867126377
"8986",506,93,413,201.61579939721,177.863256360562
"8987",487,89,398,203.804419130405,177.996670332682
"8988",489,83,406,191.004252928787,181.651897495912
"8989",492,91,401,199.474768071452,174.148493738615
"8990",489,87,402,194.379727483385,175.537654554259
"8991",484,89,395,202.114983807928,176.881824553765
"8992",469,82,387,194.832614440902,177.544197075863
"8993",501,97,404,200.2360629099,185.371689525286
"8994",495,86,409,193.435291783266,176.399256708143
"8995",473,79,394,190.730331083869,171.514624632515
"8996",475,83,392,185.966863757853,171.169380822432
"8997",484,82,402,199.887847608469,177.126148190312
"8998",488,82,406,192.582387331678,179.270699622474
"8999",481,83,398,189.34846200005,176.036040723626
"9000",499,84,415,196.825761109414,173.447391235679
"9001",464,75,389,181.258513683136,176.974961271593
"9002",477,88,389,198.924179259232,176.280465303975
"9003",476,92,384,193.683562963303,176.680457088245
"9004",474,90,384,197.856364611221,174.217357473479
"9005",482,94,388,194.37694975285,175.521115032083
"9006",481,85,396,204.900381008298,177.175259381018
"9007",475,79,396,210.318786299571,178.329887819643
"9008",477,79,398,204.80663679966,185.342590634983
"9009",494,91,403,198.654655230135,175.858738462586
"9010",482,82,400,187.730097136982,181.643561094285
"9011",481,81,400,207.840136305858,169.989712397124
"9012",487,88,399,191.520864920053,177.81785922252
"9013",491,97,394,189.587432041748,174.284213728721
"9014",483,83,400,196.976604988721,177.388606816434
"9015",500,97,403,186.755690574762,174.22567321899
"9016",483,86,397,195.284411109873,183.874158701247
"9017",471,83,388,210.964337116712,178.92049094303
"9018",499,86,413,210.128038659883,170.714401964616
"9019",494,97,397,191.277975424126,177.514089727842
"9020",481,83,398,204.562063226673,171.395840360404
"9021",478,84,394,190.786945677604,178.933629230518
"9022",492,99,393,194.04109115907,177.979685781863
"9023",502,89,413,203.780647664718,174.462716732867
"9024",476,86,390,190.963709426707,175.321361203662
"9025",493,94,399,199.135735254187,178.094482543555
"9026",481,78,403,200.242394127881,172.999235528992
"9027",474,80,394,211.370065310671,187.29142967409
"9028",499,86,413,187.356498193583,175.987592302318
"9029",479,87,392,201.487992319443,174.182882495638
"9030",491,86,405,205.948550485946,178.540748679045
"9031",480,90,390,200.938789601004,179.544411749984
"9032",483,88,395,176.164590318145,171.478598113428
"9033",489,81,408,188.202373382017,182.470011853354
"9034",494,88,406,203.097312490085,180.288666112743
"9035",482,83,399,208.7797772814,180.052097752544
"9036",479,86,393,190.864566903229,172.712261052191
"9037",482,84,398,194.966802326574,169.41243436481
"9038",493,92,401,190.262406613778,175.783264408768
"9039",495,88,407,186.447532245978,176.950514802063
"9040",488,89,399,204.562579749735,173.273707435677
"9041",483,80,403,191.023966697342,176.82834479814
"9042",475,88,387,200.908845711449,178.669213640033
"9043",479,75,404,197.265659233783,177.488991380744
"9044",472,86,386,191.673112376557,180.463922263784
"9045",484,78,406,192.430547529681,170.110514512296
"9046",492,88,404,201.857692181356,175.30232474647
"9047",491,82,409,203.579745043388,171.001384556326
"9048",482,86,396,192.134128885408,179.230456997668
"9049",485,83,402,210.379733731826,175.817305275218
"9050",476,89,387,195.531714560921,180.553209590261
"9051",500,89,411,186.012507873479,182.87392880473
"9052",487,88,399,184.516041354599,180.137513544915
"9053",495,89,406,194.309410984347,175.733181779894
"9054",500,89,411,190.304261817599,179.812862003619
"9055",490,79,411,200.451747617543,180.050769223728
"9056",493,89,404,198.814972463465,180.068082580797
"9057",488,89,399,195.760929396823,174.235488935022
"9058",493,82,411,195.520072687436,179.011604379012
"9059",460,80,380,188.2768785238,179.180321127428
"9060",478,81,397,201.398053634503,183.743042802866
"9061",473,86,387,188.840216698792,170.712463614665
"9062",512,82,430,177.715410816044,181.914053625789
"9063",482,84,398,203.691809475559,176.97215605362
"9064",476,85,391,186.151951024546,170.727216957263
"9065",488,87,401,187.802979811763,173.991564158275
"9066",503,84,419,198.871550157532,181.758255959896
"9067",467,81,386,210.481069596535,173.025640539041
"9068",481,88,393,201.257252541557,177.397194531073
"9069",478,95,383,209.250961064147,176.227730156715
"9070",495,91,404,190.28080603496,178.712989345506
"9071",487,84,403,206.550420608862,173.619162112372
"9072",475,85,390,196.029198966655,177.944571812287
"9073",473,83,390,196.643600646501,178.876187537058
"9074",498,87,411,198.752548670238,180.408475054891
"9075",481,82,399,189.928990993286,179.473712004979
"9076",484,90,394,175.24552075651,182.146375056312
"9077",495,85,410,199.088114183635,177.148362621315
"9078",480,85,395,190.891434662202,177.01956232989
"9079",484,73,411,211.490240526644,182.154522932797
"9080",490,87,403,205.270062401104,169.403791485562
"9081",481,81,400,191.037236998956,175.347604901149
"9082",487,86,401,203.891729511666,169.343547680684
"9083",478,81,397,202.62645656709,176.516646372583
"9084",481,87,394,187.480239835561,175.377499743157
"9085",478,85,393,203.703852430883,178.908414761408
"9086",477,83,394,195.187930590936,171.274534254744
"9087",500,81,419,198.101975906715,176.203895531553
"9088",505,101,404,178.376146847295,182.187169787894
"9089",480,82,398,191.172284265994,174.742135012524
"9090",473,80,393,201.640695829786,176.01358281414
"9091",494,89,405,194.836992970288,178.031676245371
"9092",470,90,380,191.510615401992,178.862983015601
"9093",489,86,403,206.875564312852,176.432011993885
"9094",492,84,408,197.663259378646,173.158901355536
"9095",484,90,394,187.828401251596,177.04821337721
"9096",476,87,389,204.740629713681,175.909967665927
"9097",478,87,391,189.497199591509,169.730215369568
"9098",474,79,395,202.851407881544,174.538177676175
"9099",495,82,413,202.786828447205,178.588242927084
"9100",487,78,409,190.903209380978,172.321968256388
"9101",480,87,393,192.634990528138,178.651286884613
"9102",488,86,402,194.104885661092,172.721679344376
"9103",491,80,411,195.714192526405,170.578832256861
"9104",492,81,411,209.379286847257,183.795246451924
"9105",472,84,388,187.810739255594,174.64828466556
"9106",484,84,400,201.211472295322,175.494359194104
"9107",500,84,416,202.623904453568,178.076656677793
"9108",504,87,417,195.675773712958,173.325888293578
"9109",483,85,398,180.753384142546,177.99788973693
"9110",484,90,394,195.363136815979,172.478540452926
"9111",472,88,384,205.09310340019,176.655781294091
"9112",486,84,402,205.474079380425,178.826529518844
"9113",489,96,393,192.290160321764,182.688703595824
"9114",497,78,419,175.979704114499,175.207266601301
"9115",493,96,397,202.123693014442,178.612235155701
"9116",492,83,409,192.854696812561,180.076302073992
"9117",497,87,410,187.22323749998,179.980338766986
"9118",479,85,394,207.55478495704,177.832318400338
"9119",503,88,415,193.827235612704,174.295905058757
"9120",468,81,387,199.287794032454,179.312075335725
"9121",490,84,406,200.204199946933,177.093638641009
"9122",485,79,406,202.007363213597,183.350380505219
"9123",485,88,397,191.367528245679,170.445669067065
"9124",475,88,387,197.906240036212,180.376987400818
"9125",484,96,388,182.347164362837,178.809331382279
"9126",475,97,378,189.442609821845,172.350760218948
"9127",488,85,403,200.165650885048,174.414864204388
"9128",482,89,393,207.551554234572,183.497223664577
"9129",476,92,384,185.092601767127,170.25508561519
"9130",481,89,392,194.972943871204,174.698984771059
"9131",477,85,392,201.846967250021,175.20139942657
"9132",475,82,393,197.608388220905,175.011665312677
"9133",479,84,395,199.293398580199,171.284392498101
"9134",488,84,404,188.186159508946,180.071041991236
"9135",483,83,400,196.40889581596,177.870145433382
"9136",488,85,403,188.017992237939,180.072545494613
"9137",478,89,389,205.647682431166,175.025975147423
"9138",484,89,395,184.543837853608,171.008193685669
"9139",485,89,396,195.987499507563,175.456952811071
"9140",470,81,389,198.490642212151,175.692971921644
"9141",483,89,394,189.314456810303,184.752686349129
"9142",487,89,398,188.152581270232,177.877386690785
"9143",481,90,391,182.471320543794,180.115950856341
"9144",499,90,409,200.057950977055,181.165515428382
"9145",468,80,388,198.84085734026,178.183383605475
"9146",498,86,412,197.661164301128,175.756513577293
"9147",491,80,411,204.670371904795,179.338746365988
"9148",472,82,390,201.006904047189,175.33850932202
"9149",500,80,420,201.594331705457,180.580965286163
"9150",497,86,411,203.216589546229,177.764120919449
"9151",488,89,399,186.742559021466,184.582122915797
"9152",479,75,404,198.485510481259,179.627832132895
"9153",460,88,372,205.159657612902,176.176009220036
"9154",500,81,419,194.592144593724,174.443696902848
"9155",481,86,395,188.424112920674,183.737477240445
"9156",486,91,395,193.702528990703,176.629571714113
"9157",465,74,391,196.356549869223,181.826955123709
"9158",479,82,397,195.084133666568,171.805982316057
"9159",481,85,396,188.17932653072,170.483351197845
"9160",496,83,413,205.717396846003,176.404561272241
"9161",478,85,393,195.858898005852,178.432753862597
"9162",478,85,393,199.908421711787,181.679130880556
"9163",480,84,396,187.613646069924,178.626651774257
"9164",492,88,404,205.262751261259,177.697381118558
"9165",481,91,390,191.747664738024,171.984084018551
"9166",468,82,386,193.571828490173,177.009624000293
"9167",466,81,385,198.208792294991,179.508833642303
"9168",474,83,391,203.569246829908,170.929263540423
"9169",490,84,406,187.645173278769,174.431151584121
"9170",489,87,402,191.461434521487,176.372379087659
"9171",509,93,416,192.472739656832,177.197085668095
"9172",491,83,408,203.489636340049,179.139611318065
"9173",482,92,390,194.851729025377,177.904309346914
"9174",475,86,389,206.735862084196,179.101842736528
"9175",506,90,416,193.831710772118,173.292103137332
"9176",505,90,415,202.596212194788,176.416640980701
"9177",484,88,396,193.823646875929,173.367685959634
"9178",494,84,410,206.904942445969,175.724159681207
"9179",487,89,398,196.790909818912,175.371545968686
"9180",482,80,402,200.960707451597,172.9918448269
"9181",487,91,396,185.000327880515,178.477997646181
"9182",479,84,395,190.380426241018,175.87178660039
"9183",488,86,402,201.777937631883,179.597654038396
"9184",481,93,388,204.562065888863,176.233918594917
"9185",494,86,408,184.883120524005,170.040651435145
"9186",473,81,392,197.727640375064,182.883135117408
"9187",476,83,393,191.808051587893,176.04792878748
"9188",486,82,404,191.649178412874,175.456905153042
"9189",483,87,396,196.137785084383,176.785101302231
"9190",493,85,408,203.99409168402,176.971179675384
"9191",491,94,397,186.1679605554,183.130354070616
"9192",498,93,405,218.816329739704,176.925522784651
"9193",487,92,395,191.146994117428,176.915174633173
"9194",477,82,395,193.589378578042,176.391963645935
"9195",490,84,406,195.206009280251,171.010229484783
"9196",494,94,400,185.988434955656,176.901716794231
"9197",486,94,392,185.117717264862,181.015328410137
"9198",490,83,407,198.405293438033,179.830994370078
"9199",493,83,410,181.32202591464,174.229507222212
"9200",504,92,412,193.984200546256,176.326896920704
"9201",477,84,393,204.788236021654,176.845681690908
"9202",490,88,402,202.573198051082,179.854643440549
"9203",497,91,406,196.628111905307,172.818163262518
"9204",487,82,405,188.843525693873,176.609682632601
"9205",482,87,395,182.720822418917,179.330154699819
"9206",483,86,397,193.327177305501,175.528938478922
"9207",478,80,398,203.579596219841,181.332995084847
"9208",486,88,398,195.562334865873,177.175299299981
"9209",495,89,406,178.153207932758,179.682093637293
"9210",488,87,401,189.385618339185,173.198569814207
"9211",497,89,408,195.585400618114,177.505297458024
"9212",491,82,409,180.675134705694,175.994858416491
"9213",473,82,391,189.828519970352,179.719855129743
"9214",492,85,407,181.956760156219,176.720447141985
"9215",493,85,408,208.536267463481,177.511182315475
"9216",487,92,395,194.093067006947,180.33886564801
"9217",492,86,406,201.155117735011,179.09590654238
"9218",480,84,396,181.000859365924,178.159552544474
"9219",477,88,389,181.593718643512,180.729836646686
"9220",481,81,400,202.145295609555,171.726106718675
"9221",486,85,401,200.963851635775,178.546276705052
"9222",492,89,403,198.573731638938,175.125312820671
"9223",490,79,411,198.025733466219,182.370875537357
"9224",481,77,404,207.634962293069,176.754123527288
"9225",478,87,391,198.046360511014,177.667741829579
"9226",498,86,412,195.616486300303,175.950510411871
"9227",492,90,402,196.945930528512,171.672151883656
"9228",511,92,419,193.280433770391,176.297811692633
"9229",483,86,397,185.87992184807,176.781712843441
"9230",480,81,399,200.599971930907,176.241636573856
"9231",490,92,398,194.904027243224,175.412022527968
"9232",492,92,400,202.384909904853,177.176823489365
"9233",489,91,398,190.722646060945,175.87924303527
"9234",488,94,394,188.780333353711,178.179852419132
"9235",484,89,395,193.910463287821,172.795551902885
"9236",481,78,403,194.560112538227,171.595400052625
"9237",472,83,389,208.986141759065,179.23380954508
"9238",484,86,398,181.447725153569,172.287802632625
"9239",490,85,405,196.481853047428,177.082072480072
"9240",479,95,384,196.94255148271,183.210316331347
"9241",492,87,405,176.708757836286,177.71150539884
"9242",464,79,385,201.175669791499,179.113078435106
"9243",481,80,401,189.925568524383,173.337410173833
"9244",493,88,405,198.452107696556,175.487831886687
"9245",482,89,393,181.025079192548,182.932501151062
"9246",493,93,400,203.751237453358,175.526622154278
"9247",488,84,404,198.357842683385,181.992229227361
"9248",472,82,390,200.300384943351,175.608297292595
"9249",495,88,407,184.775594753632,174.354218013414
"9250",466,78,388,188.324959041501,179.160827390017
"9251",486,83,403,180.137980184095,179.524771275268
"9252",470,80,390,205.31535928181,181.889242591127
"9253",459,76,383,202.025004333191,180.800459610058
"9254",489,85,404,189.674599484787,181.005135749959
"9255",489,83,406,195.199816698674,174.339654698023
"9256",486,85,401,194.560643831163,171.924286256704
"9257",488,83,405,200.326073015113,186.099033597828
"9258",475,78,397,196.486364431611,178.33296443612
"9259",468,81,387,186.160100087119,175.776704559437
"9260",485,84,401,198.350256418415,174.010320388686
"9261",471,88,383,196.497433356825,178.220008066039
"9262",491,82,409,198.206617698664,175.780320877814
"9263",491,81,410,191.315452052711,179.807292858592
"9264",483,90,393,194.655025917734,174.932226077759
"9265",491,89,402,191.948337313023,178.010168188538
"9266",467,80,387,198.188311294043,173.265076611281
"9267",480,75,405,202.542876849624,182.964990043779
"9268",484,92,392,193.783722232741,172.813552374375
"9269",493,94,399,190.773936740647,174.438578822365
"9270",482,83,399,188.929069157913,180.207672239303
"9271",480,92,388,190.817002737814,171.433545726328
"9272",474,81,393,205.932144158911,184.477635013053
"9273",475,87,388,194.504399482689,177.57589201635
"9274",504,85,419,194.534383611998,178.290183282463
"9275",493,94,399,193.111109444267,172.907066310143
"9276",461,78,383,185.816488543659,180.341118542803
"9277",482,85,397,192.248491121993,177.297121620298
"9278",495,87,408,185.971357822611,175.507590982974
"9279",499,91,408,194.51672497862,176.908631269486
"9280",474,82,392,197.984783231703,178.791982362543
"9281",482,81,401,205.526024463418,174.200631976611
"9282",477,97,380,193.599456421521,171.315103271985
"9283",479,88,391,176.719270198216,174.640494736726
"9284",488,92,396,198.009874269463,181.244719176211
"9285",473,85,388,193.166168900637,172.030960791658
"9286",471,93,378,197.779764492736,172.911180324025
"9287",465,88,377,174.503925089457,175.720522142154
"9288",503,88,415,186.622612161697,181.635151610925
"9289",480,86,394,209.003855621932,177.559030233963
"9290",494,89,405,202.326453470881,171.4831636869
"9291",490,84,406,194.247003927856,179.940844921148
"9292",491,84,407,201.171665810755,176.755863621147
"9293",475,81,394,202.944653991348,175.58722748398
"9294",503,83,420,194.985684727378,175.11325588597
"9295",477,88,389,179.36090880512,179.908010802952
"9296",484,94,390,191.545201551631,173.972243384256
"9297",498,87,411,190.656848583179,185.802124168134
"9298",478,93,385,196.071892846711,175.808621679849
"9299",487,78,409,184.606916150754,168.909022239387
"9300",475,85,390,190.252220054533,175.629822774789
"9301",477,85,392,185.042013020354,177.776758226052
"9302",486,85,401,192.279619539671,178.428264247418
"9303",474,78,396,194.214529426199,172.62187379182
"9304",491,91,400,185.165465097973,179.736022947361
"9305",482,85,397,191.053019243539,180.303586817528
"9306",483,87,396,179.2297669062,173.035885120349
"9307",487,81,406,196.204537319367,170.050757366234
"9308",476,92,384,184.234185170807,174.213473152571
"9309",490,89,401,196.009785384462,179.606670495071
"9310",489,97,392,191.107599568619,175.520937141304
"9311",480,82,398,190.193675022279,171.784410690691
"9312",492,88,404,190.318684631011,175.282328102631
"9313",495,81,414,200.359363788104,179.132141762107
"9314",474,86,388,201.632240296122,181.237024354416
"9315",488,85,403,193.25471467202,174.106619289267
"9316",463,80,383,185.257209434595,170.090073535223
"9317",486,82,404,175.122032970433,172.279356706199
"9318",468,79,389,185.574904108724,178.172665674145
"9319",483,85,398,196.292886294347,176.860797040848
"9320",483,83,400,190.735858517654,179.936751945174
"9321",459,78,381,186.61532841233,181.133161480745
"9322",486,84,402,200.716188362241,176.701516217606
"9323",503,90,413,189.360507609941,175.969492005127
"9324",492,88,404,188.777492540525,175.875268663268
"9325",494,86,408,191.30373283121,180.707300727926
"9326",490,99,391,186.647999483221,172.249861341134
"9327",479,84,395,197.873833999235,178.082039438808
"9328",481,77,404,196.997604378579,175.075793720386
"9329",483,85,398,190.6562136179,177.639828544566
"9330",486,85,401,187.326789642342,178.156012908659
"9331",499,99,400,178.807024285181,175.188462617298
"9332",506,90,416,195.116354844521,170.582531690588
"9333",496,88,408,196.586486781596,170.97866540733
"9334",483,88,395,191.919780979295,182.63663419472
"9335",485,87,398,188.669534403363,176.364242735478
"9336",479,81,398,189.645090382775,180.096716470849
"9337",492,82,410,198.780212411888,176.186094448333
"9338",477,82,395,196.692150336194,171.989513745296
"9339",500,88,412,200.031659645086,172.549119565978
"9340",472,88,384,211.641893882025,182.612314628623
"9341",479,87,392,194.281607447132,174.721715694603
"9342",486,83,403,200.932672578131,180.299579577847
"9343",494,87,407,184.333017338571,175.533110442891
"9344",488,90,398,199.396346660257,178.792509442251
"9345",489,90,399,202.742710123088,175.762350757973
"9346",486,85,401,182.837782469596,172.46230756297
"9347",480,84,396,208.466040705731,175.06498193131
"9348",475,85,390,185.310093840392,179.739910419559
"9349",490,84,406,181.193213177978,178.070377967492
"9350",490,86,404,203.272080782776,177.615005216142
"9351",482,80,402,189.880012191816,178.505689973529
"9352",485,84,401,204.959565577769,181.020186759629
"9353",499,91,408,186.655938622929,173.407557660031
"9354",464,84,380,198.922064209645,168.217990291691
"9355",483,85,398,197.860132852745,183.142939112824
"9356",494,84,410,201.516018256218,172.435573982767
"9357",487,84,403,199.536634619352,176.283418846252
"9358",493,78,415,196.699864551442,172.977452300855
"9359",486,91,395,189.176055757157,175.918573986942
"9360",469,80,389,217.112695537656,179.615237086012
"9361",482,81,401,168.928247033776,174.979391231157
"9362",479,81,398,212.95781140829,176.628335730538
"9363",466,83,383,197.827259667118,177.490201945024
"9364",476,85,391,191.014033889087,178.013829745237
"9365",486,89,397,209.48818086282,175.291162109835
"9366",487,78,409,196.597701285173,179.091183438682
"9367",482,88,394,198.251931001574,179.926344831922
"9368",502,84,418,190.159731450159,179.379554042858
"9369",486,86,400,189.292449089683,172.065158305912
"9370",463,81,382,192.235639512797,181.972453542363
"9371",494,84,410,201.402240660828,176.892863234015
"9372",485,88,397,188.174425920039,179.970526541715
"9373",480,87,393,203.777189199757,174.719810807974
"9374",486,91,395,190.236280266998,172.210361129538
"9375",484,88,396,193.577927997159,174.137943702264
"9376",479,95,384,186.27817019625,179.768526770185
"9377",477,84,393,182.895892870053,177.550660415272
"9378",501,87,414,193.234568830382,179.117860381106
"9379",473,83,390,204.017082349723,175.055207148705
"9380",488,93,395,185.200433834738,169.069207371752
"9381",497,95,402,196.346060869576,170.190496346441
"9382",467,81,386,191.278570735085,178.990193873962
"9383",484,82,402,192.449577809194,177.458850758325
"9384",495,96,399,212.537739819125,172.248996937826
"9385",470,84,386,197.00521227742,173.555175388483
"9386",499,87,412,190.335173950022,174.829604359148
"9387",477,86,391,205.311111198528,171.203357562233
"9388",504,91,413,205.425268042805,179.815598496832
"9389",464,79,385,203.698041344294,173.693240913844
"9390",488,85,403,204.691526757615,180.663677485532
"9391",503,86,417,188.44070233159,178.144039160045
"9392",493,89,404,202.879816141134,174.236270242339
"9393",476,80,396,205.337433594313,173.689283044703
"9394",490,86,404,199.772791706517,175.071843888989
"9395",481,84,397,205.931402690092,172.953693631727
"9396",489,84,405,194.48826580249,175.938577803365
"9397",489,92,397,198.81544341693,179.536004899959
"9398",477,85,392,193.954935966666,181.181349845411
"9399",466,82,384,192.027899954579,180.026671090716
"9400",485,88,397,186.935280108004,178.159931116696
"9401",479,77,402,197.788604213713,171.346392778891
"9402",479,90,389,185.920663416422,178.928635994525
"9403",501,88,413,195.492373225777,181.125229387335
"9404",489,86,403,192.384947626004,177.852821988782
"9405",479,91,388,190.982027981149,175.707578718725
"9406",475,80,395,190.293756898933,171.594728021853
"9407",492,90,402,188.933246335506,181.906515717174
"9408",485,89,396,195.675189282193,176.035032140926
"9409",482,96,386,187.059074496608,181.131134990137
"9410",465,88,377,201.516277002923,176.811128784801
"9411",486,83,403,206.889981205907,171.374730794341
"9412",500,91,409,200.212716570593,178.697081625082
"9413",477,84,393,186.95503511955,180.140658614908
"9414",490,87,403,186.946564548389,183.348016514602
"9415",491,83,408,205.062624640045,178.527767689841
"9416",480,88,392,192.667047223419,176.658392921146
"9417",490,92,398,199.259634376674,175.952747214768
"9418",479,91,388,186.429760900823,173.312385344401
"9419",503,98,405,194.386362536807,176.820967229833
"9420",480,95,385,205.55877450973,177.048140506878
"9421",494,91,403,195.865114559906,184.802954059735
"9422",494,93,401,190.376888390134,180.305752737916
"9423",487,86,401,186.394352769071,182.910683794362
"9424",494,81,413,188.869676508173,181.662996913653
"9425",484,78,406,195.29529136778,175.771082634773
"9426",477,78,399,201.188002788916,179.360307921804
"9427",477,82,395,204.652152624675,175.882792714884
"9428",490,82,408,206.892073852494,181.125898330472
"9429",486,91,395,193.45272560927,176.898958904807
"9430",475,86,389,183.822332774146,176.065490824677
"9431",488,89,399,179.398140148136,182.591858505291
"9432",487,88,399,191.30040926988,171.537509073455
"9433",495,93,402,202.772357981604,177.079698209469
"9434",506,90,416,190.938000452391,175.940619962823
"9435",483,86,397,199.149112276706,178.373520787889
"9436",502,91,411,186.25835143354,173.876944734979
"9437",486,88,398,201.26839076148,173.360555250544
"9438",485,86,399,190.572196125941,177.225898523368
"9439",488,95,393,190.212858153587,180.456735850754
"9440",480,83,397,194.357844357842,171.376645019541
"9441",496,91,405,200.779861665219,169.836875436758
"9442",492,95,397,204.970042908505,179.794537806439
"9443",498,93,405,197.784114178882,174.512186340206
"9444",488,86,402,185.294507706553,183.326661006405
"9445",490,80,410,204.706732575337,174.480699239456
"9446",486,89,397,196.409134962296,175.602521746851
"9447",497,83,414,192.362109498641,175.140520662234
"9448",476,82,394,197.400299323238,177.218710230863
"9449",473,81,392,206.346569608297,181.014254089918
"9450",485,78,407,190.660023862243,177.151285059463
"9451",455,78,377,192.905741813698,176.977183034124
"9452",487,85,402,200.065002006613,170.600907213362
"9453",479,81,398,208.827212249097,177.912666678434
"9454",481,84,397,201.496223355406,174.880171981092
"9455",484,95,389,191.641254975846,176.782982626969
"9456",488,85,403,198.732820253548,178.262134081464
"9457",495,93,402,194.803942657081,180.900689784261
"9458",506,88,418,200.074405943061,175.71126866594
"9459",487,92,395,207.685159123915,185.015274267456
"9460",474,92,382,194.703491981076,174.36633000559
"9461",498,93,405,188.883300691305,170.542020780451
"9462",470,88,382,202.391791714995,179.682518656753
"9463",487,94,393,197.609569173657,173.942105162738
"9464",491,75,416,204.452458371814,179.369957454974
"9465",498,89,409,191.393391558992,171.436466154495
"9466",470,83,387,193.083385662246,173.805903942779
"9467",491,93,398,197.810392640595,176.2694473948
"9468",480,83,397,193.733441772763,179.602672448126
"9469",464,79,385,208.079436337797,174.621219325487
"9470",482,76,406,189.412652286056,182.629108237896
"9471",492,88,404,187.183364291426,169.815623352148
"9472",490,92,398,197.185443347756,176.16107075939
"9473",474,78,396,198.247524583621,171.421122468287
"9474",489,88,401,190.668199683067,181.722307107417
"9475",481,85,396,210.728355785667,183.976217156983
"9476",471,83,388,193.833691805258,175.306777984649
"9477",480,90,390,192.948707940464,177.72419308995
"9478",484,90,394,185.113717688088,174.702662922983
"9479",490,82,408,205.86835840142,177.523114235362
"9480",471,81,390,188.732353274315,175.883809661691
"9481",502,85,417,201.791831824019,172.658930921178
"9482",475,92,383,189.226997569881,177.63334484384
"9483",492,87,405,183.395097598698,176.560725740237
"9484",491,86,405,196.491309406668,174.830951076679
"9485",489,90,399,178.503651102822,171.800783438605
"9486",483,91,392,187.301346523513,176.344382443483
"9487",464,82,382,197.159986556574,176.78620850065
"9488",466,82,384,203.962802666867,174.60009636705
"9489",475,84,391,199.653940743667,175.925621015046
"9490",482,93,389,195.818598437783,174.619866445993
"9491",484,92,392,177.178177709195,175.367772615325
"9492",484,84,400,200.853566459178,175.101500331992
"9493",510,99,411,192.328052704299,171.853028153939
"9494",501,82,419,196.150043988695,182.10447747538
"9495",490,78,412,175.790259004535,181.212277305468
"9496",493,84,409,199.35069124157,174.466145092937
"9497",495,88,407,194.096194263427,172.030347155294
"9498",469,75,394,200.934125329274,169.860383266684
"9499",472,92,380,199.876057896749,172.814081875747
"9500",469,82,387,190.310383973412,179.240621623612
"9501",476,86,390,181.995077537554,175.432172370238
"9502",474,86,388,199.355322029151,169.319187817636
"9503",478,87,391,196.141311704869,177.377628557585
"9504",481,89,392,192.910527379079,175.782207384391
"9505",500,95,405,198.862478146665,177.126852748686
"9506",489,88,401,183.281401656151,174.398024358297
"9507",484,80,404,188.605330982193,175.000196293011
"9508",464,79,385,202.010216934768,180.362219071078
"9509",476,80,396,203.009376325199,179.14786260282
"9510",470,85,385,194.760129358161,183.884687807456
"9511",490,92,398,181.253229400074,172.052349351714
"9512",481,86,395,179.589028630685,177.92186948895
"9513",486,90,396,188.778744089818,170.863544467764
"9514",471,86,385,185.973270027298,178.772230316498
"9515",486,80,406,199.905569256368,170.765315286578
"9516",474,77,397,188.519544293007,174.924530510934
"9517",480,94,386,193.011802284619,176.870380820237
"9518",471,88,383,182.981228213677,173.81600756557
"9519",490,79,411,190.738666424711,180.183088498039
"9520",484,86,398,193.330517883272,179.279173599681
"9521",475,83,392,194.608582916862,169.606154706578
"9522",498,92,406,197.831191198025,178.257393249645
"9523",496,83,413,196.969893146908,177.068488851034
"9524",477,82,395,202.981829810377,176.405564570313
"9525",495,90,405,182.475303103638,175.975664518685
"9526",483,86,397,194.030090193938,171.770190718018
"9527",487,81,406,198.207933617755,177.46024172479
"9528",465,80,385,202.304486204507,183.150838815462
"9529",475,85,390,205.935245804064,175.23112481192
"9530",473,82,391,203.422229529163,172.512056232206
"9531",479,94,385,190.665581245489,178.496325904019
"9532",480,90,390,201.962223549056,174.539338904383
"9533",499,97,402,196.714946302562,174.059327393803
"9534",494,81,413,179.155528611899,175.500886968539
"9535",479,87,392,193.169964709311,175.245591752659
"9536",487,83,404,197.864585177499,177.026415594055
"9537",469,84,385,186.514804516016,172.636882074098
"9538",488,88,400,203.518923487087,182.098605416802
"9539",478,77,401,195.267137328252,172.56626814266
"9540",486,84,402,200.474075123274,180.11636827569
"9541",486,91,395,203.268727506784,172.883753239791
"9542",504,86,418,196.083611334719,185.544537353486
"9543",480,87,393,210.307608103707,176.588050764333
"9544",501,88,413,188.945226611757,176.569183762587
"9545",485,87,398,190.086821501961,175.333076441311
"9546",479,81,398,201.082483363011,174.656455855167
"9547",496,94,402,195.126854114837,177.788302952785
"9548",491,86,405,201.472484148631,170.286236285476
"9549",489,81,408,201.508622769628,173.609887036882
"9550",488,87,401,196.728093130072,175.03790686589
"9551",471,88,383,199.310893817073,177.858836871995
"9552",488,81,407,185.980784698964,174.116057745716
"9553",480,85,395,177.139310002946,180.153942460121
"9554",481,78,403,187.776096785739,180.502543973532
"9555",479,85,394,190.783186363455,180.907073629914
"9556",485,88,397,203.763258488665,169.070197257806
"9557",474,85,389,187.124491680564,174.710694585888
"9558",479,86,393,172.029600746889,179.981448502917
"9559",492,85,407,187.088100385152,171.668896520875
"9560",474,78,396,195.417578139094,173.233398299913
"9561",499,85,414,185.58057489805,179.897769327428
"9562",471,86,385,194.257998573343,169.324218094725
"9563",486,84,402,188.102682594503,179.714634216928
"9564",481,90,391,194.306687031591,172.193668510626
"9565",466,80,386,194.995944626483,171.895639677143
"9566",484,87,397,194.969169270435,173.327384575926
"9567",503,94,409,199.551318844537,176.117279675307
"9568",498,99,399,189.954062768197,180.150301481029
"9569",471,84,387,188.625312337614,173.725198610972
"9570",476,88,388,189.642379643901,174.802207975886
"9571",492,87,405,195.789560624262,175.784534151394
"9572",490,88,402,186.053843960963,175.487757397859
"9573",480,89,391,192.797005972157,172.281859552078
"9574",482,87,395,205.515162526752,176.217293216144
"9575",500,83,417,200.395254349761,180.397917498128
"9576",472,91,381,184.196801804443,179.845688471657
"9577",478,89,389,203.19906143605,175.437772655394
"9578",481,85,396,191.545747864838,181.478369411471
"9579",482,89,393,185.490112657837,177.907877618645
"9580",489,83,406,204.155557564605,179.817532125436
"9581",460,76,384,197.300100117566,173.302612935903
"9582",480,85,395,205.29493212498,177.522610693161
"9583",480,85,395,193.392495077671,184.774807258684
"9584",467,85,382,191.355274557803,177.298316579818
"9585",494,81,413,196.181435342444,179.137120769276
"9586",479,83,396,208.044559789936,179.204120051699
"9587",480,82,398,199.587267662891,173.848443644565
"9588",466,77,389,206.067248214039,178.732036685564
"9589",477,83,394,202.786307380895,177.407492202986
"9590",487,79,408,193.982296851642,187.693570673363
"9591",476,78,398,193.766082534387,177.975413144919
"9592",497,80,417,214.595259945206,175.149175658043
"9593",497,90,407,185.663249991227,178.311785771054
"9594",485,85,400,188.169529301225,174.463177922134
"9595",483,90,393,195.523549608502,179.285338841872
"9596",494,87,407,187.236039089096,182.374522542986
"9597",478,84,394,197.898057404511,182.010989157516
"9598",474,85,389,200.37982062826,179.971877547319
"9599",487,88,399,199.713285418274,179.303935125368
"9600",481,81,400,186.976410919229,173.931736861286
"9601",494,92,402,192.046373943515,177.124241451969
"9602",497,91,406,198.397584292501,178.763013455676
"9603",475,88,387,200.120780946051,177.760354629323
"9604",487,89,398,196.826878587481,181.418574245096
"9605",497,84,413,196.087257718666,181.170786967665
"9606",484,78,406,199.415441803165,177.801180520652
"9607",483,76,407,197.153780134409,181.432720919712
"9608",472,82,390,213.989575116506,174.645904090048
"9609",486,81,405,193.586409033595,179.515305164352
"9610",473,82,391,214.694240525874,176.342657249617
"9611",494,81,413,204.576688896547,173.115221425576
"9612",478,73,405,201.642376978274,178.530379251469
"9613",481,85,396,190.166136976402,179.834024653488
"9614",476,80,396,198.849479689417,172.357878976957
"9615",474,83,391,185.222424479355,172.972412782396
"9616",485,94,391,198.151678365254,174.951076328323
"9617",497,87,410,199.003318017479,179.279205843702
"9618",481,86,395,191.947641198957,174.722232935261
"9619",482,87,395,197.748906189142,173.018073566429
"9620",479,81,398,192.677851075505,175.370014315642
"9621",481,84,397,188.306312406053,179.937810330881
"9622",486,86,400,192.017028382322,178.364245276271
"9623",476,77,399,198.38913937493,174.228578327175
"9624",502,96,406,190.722999752765,182.106444052772
"9625",497,88,409,182.642951482887,172.738342571954
"9626",484,87,397,196.556337531987,176.60591447772
"9627",468,87,381,205.509337477195,179.015614344978
"9628",501,90,411,199.438129628924,178.782288642054
"9629",482,89,393,194.002948332413,175.85072523692
"9630",478,86,392,181.939334346832,179.676853965217
"9631",481,83,398,195.458272360045,182.547312219682
"9632",474,77,397,194.795585650276,171.048272412843
"9633",476,75,401,195.397818538941,171.864076770255
"9634",488,100,388,185.294668770143,177.833039457593
"9635",478,79,399,199.904416241339,177.233873329767
"9636",486,83,403,193.606264740022,181.025681229061
"9637",486,86,400,196.773561084582,173.381123149885
"9638",487,87,400,200.571593361614,172.783539147927
"9639",492,81,411,203.426462586934,174.503095775694
"9640",477,75,402,202.632312204302,177.634923088907
"9641",501,87,414,197.809217504508,177.717849838873
"9642",494,91,403,198.819294904974,177.149579672713
"9643",482,80,402,199.232926539316,173.837468438765
"9644",473,86,387,186.647164991479,180.916012428492
"9645",491,94,397,212.348360805953,177.964884062824
"9646",490,90,400,193.840860402072,177.078446753032
"9647",483,90,393,199.560981480869,174.378048515758
"9648",475,78,397,205.509454572472,173.778821777937
"9649",484,88,396,202.956939528477,169.009416386854
"9650",495,90,405,201.952971564538,174.818666278392
"9651",481,90,391,177.771164110166,175.421312255169
"9652",479,80,399,181.149831957064,182.359446242465
"9653",490,85,405,184.550849702779,178.355454570302
"9654",485,80,405,194.405173937561,168.472335442952
"9655",493,84,409,195.547193080628,176.283599710819
"9656",480,83,397,186.402268787665,179.382038098496
"9657",463,76,387,191.999510494996,175.216670475257
"9658",499,99,400,197.699142868362,172.559107119444
"9659",500,91,409,195.934289074421,172.442606532645
"9660",483,84,399,187.053532962235,174.522184599609
"9661",481,88,393,195.834162427666,175.017885551948
"9662",480,81,399,201.007277287527,178.780479478054
"9663",492,90,402,195.390081672437,175.161692179329
"9664",481,83,398,193.286433558361,171.911091683194
"9665",491,85,406,191.524041124417,179.27682421197
"9666",485,88,397,185.88700934884,179.038710548129
"9667",478,89,389,191.406533982528,183.225863608516
"9668",469,84,385,190.234835384045,184.299002312315
"9669",476,81,395,195.230716678661,175.551343591202
"9670",495,92,403,195.070437318095,182.077388726468
"9671",483,86,397,181.474708009438,177.030011294761
"9672",486,80,406,193.687740119431,176.122163729787
"9673",493,89,404,190.751501946189,177.094199174724
"9674",505,86,419,197.469051681944,173.505043041794
"9675",483,84,399,204.143466944876,176.47722640886
"9676",491,90,401,197.041497590488,180.464830121788
"9677",465,87,378,196.438014418491,173.981058449884
"9678",493,90,403,198.016083627797,178.53893223164
"9679",493,87,406,188.112394845684,181.636182899731
"9680",480,79,401,190.010102069267,171.925792345073
"9681",493,87,406,191.138112792022,172.808121740496
"9682",476,75,401,187.246364841081,179.031655753553
"9683",503,85,418,193.536308708571,178.218594069622
"9684",483,76,407,189.758616010472,176.088031314996
"9685",478,87,391,199.782780924902,176.904869838711
"9686",489,79,410,208.096265165941,174.797821403132
"9687",500,95,405,191.261989524703,182.719714707771
"9688",484,85,399,197.992589151491,176.18666221927
"9689",478,85,393,191.479984636225,173.749912735645
"9690",491,93,398,191.905630586806,173.548362996291
"9691",498,92,406,197.513766228178,180.208064570052
"9692",475,87,388,206.540465459057,177.940191290852
"9693",492,84,408,207.639095525515,182.695956122336
"9694",485,92,393,193.94543070611,179.519661828432
"9695",479,90,389,204.155068661429,179.392527888032
"9696",487,89,398,197.886214679282,177.706118615392
"9697",472,89,383,183.641609821372,174.280606188807
"9698",472,75,397,191.062897905122,175.42665711069
"9699",481,83,398,191.632574036688,174.450808389302
"9700",475,83,392,184.284101329845,173.85790662114
"9701",483,88,395,191.411572969009,177.540279026782
"9702",491,85,406,183.724756595757,171.182300886512
"9703",503,90,413,194.136238385068,173.058362633597
"9704",487,82,405,191.994207969485,177.147436623516
"9705",479,82,397,199.807876015986,177.326893810308
"9706",476,83,393,195.77470879153,183.097855518489
"9707",501,87,414,180.724875199393,167.722648469909
"9708",477,85,392,187.529182880805,179.179656342109
"9709",476,82,394,201.725731551297,177.997244736563
"9710",496,87,409,183.204335678019,172.351750879158
"9711",467,87,380,189.452759660845,185.299900937367
"9712",501,93,408,212.929028684498,171.382280398543
"9713",475,91,384,199.084128227145,175.611946980226
"9714",493,88,405,190.911680331126,181.131330241455
"9715",468,80,388,195.682802457897,177.944585314553
"9716",482,80,402,197.803855055942,172.505956394636
"9717",494,88,406,190.437089554417,174.734685385883
"9718",487,94,393,190.433048770863,170.103738425827
"9719",486,84,402,191.004021219055,174.773562412628
"9720",481,81,400,192.644233480924,176.194369669405
"9721",488,90,398,189.367245536505,179.595187694199
"9722",489,86,403,195.72446242119,174.191663794492
"9723",500,89,411,190.661139696774,180.34286271727
"9724",469,87,382,201.954560938657,177.524483414246
"9725",491,87,404,198.2072795467,181.300789541349
"9726",488,80,408,193.113877376836,178.104002419917
"9727",493,89,404,194.782960680623,178.799441611334
"9728",495,89,406,188.058872198452,173.549020632063
"9729",482,94,388,196.986413066751,173.763345932316
"9730",470,78,392,187.477001447943,174.454558484601
"9731",482,91,391,190.511898723937,184.3076118853
"9732",480,83,397,174.290638617454,173.371563542095
"9733",499,85,414,190.403321473899,176.661850615985
"9734",477,93,384,189.538621481907,185.15056030365
"9735",486,88,398,204.953835805565,173.638120642981
"9736",470,86,384,195.421087352974,180.235220152739
"9737",495,88,407,212.93923670033,176.553397077575
"9738",490,85,405,193.844862033941,177.288531034212
"9739",497,90,407,200.830927347523,172.637461680085
"9740",492,86,406,205.654147806042,178.184169119282
"9741",488,90,398,189.216349228073,177.208232871187
"9742",491,82,409,195.498471158231,179.932517896623
"9743",489,90,399,210.127923482188,171.692270144686
"9744",480,77,403,195.590046337978,177.721191626721
"9745",470,82,388,184.578808731334,173.118403903808
"9746",492,77,415,195.061494284043,176.085157997193
"9747",488,79,409,193.960275247318,172.59349219748
"9748",498,87,411,182.076200690435,169.377040663433
"9749",471,80,391,193.222823594217,178.159706070144
"9750",483,84,399,193.455093143505,173.881119011975
"9751",482,82,400,203.37864505296,173.765975131052
"9752",492,80,412,202.94100321878,171.947004709395
"9753",487,92,395,194.805136936705,175.024651847636
"9754",483,81,402,181.762117257177,172.952154566174
"9755",482,77,405,194.226900747453,175.651111129892
"9756",479,88,391,211.235010292903,172.29066879428
"9757",490,86,404,197.238897037057,179.253829365944
"9758",491,93,398,204.037902513839,174.541635993864
"9759",486,80,406,192.91803795685,180.634109624432
"9760",476,87,389,198.225588144716,173.562768338459
"9761",480,90,390,201.362327958913,172.136415577542
"9762",493,81,412,202.188255137387,180.420109053795
"9763",478,75,403,210.627607250636,174.498698392526
"9764",488,88,400,190.903426753872,179.285299576652
"9765",442,80,362,195.480886346655,174.963868026956
"9766",493,93,400,192.473355674964,177.074217141584
"9767",477,87,390,204.362009571087,170.152329729413
"9768",493,92,401,191.862608510903,170.804589913224
"9769",483,90,393,200.734658232585,173.862691923312
"9770",490,85,405,205.742418278288,177.531362012061
"9771",488,82,406,197.862085019358,181.216119595518
"9772",488,79,409,205.796085248567,178.921628694551
"9773",494,90,404,185.80654391268,176.055042020943
"9774",492,78,414,196.913990749628,179.141609274846
"9775",485,85,400,188.575099356742,179.965290753205
"9776",478,76,402,211.90949889315,178.925812193633
"9777",491,89,402,189.827196348554,183.796525509915
"9778",489,90,399,187.380274201104,174.43231401301
"9779",495,89,406,198.810519342379,171.528542157072
"9780",476,84,392,208.514635275855,175.839106862245
"9781",495,76,419,211.498738717226,177.016589288346
"9782",495,96,399,202.055400041459,183.110792557806
"9783",488,87,401,186.416644601907,178.028794959142
"9784",494,87,407,208.621584864606,175.549109766935
"9785",494,94,400,180.946189808547,174.465302209223
"9786",468,83,385,202.104547692578,177.73092323405
"9787",484,86,398,183.071687163253,180.175859598452
"9788",467,81,386,190.966002210659,179.095816741959
"9789",491,88,403,187.550896958499,176.99118211856
"9790",478,91,387,172.957333745693,175.01941494811
"9791",486,81,405,198.995690396828,175.864973739841
"9792",500,89,411,194.444642555531,175.672076099416
"9793",488,79,409,190.543846732889,182.895446144321
"9794",477,85,392,203.715645193277,176.417548674839
"9795",473,84,389,190.509778676352,181.814149964903
"9796",484,90,394,186.149357825326,177.643927031802
"9797",485,86,399,208.552012218517,180.537890763691
"9798",478,81,397,204.237910716399,170.673089099433
"9799",478,91,387,197.876405538887,172.623930626825
"9800",482,97,385,209.711163339015,176.085941593698
"9801",486,95,391,190.30132091469,175.871715882145
"9802",492,87,405,188.702673605971,174.389846890074
"9803",499,94,405,187.833183004062,175.118571426676
"9804",489,84,405,198.679957361024,177.988567859858
"9805",475,78,397,194.520352062448,175.654618129723
"9806",483,85,398,197.196609618502,181.361083244221
"9807",488,92,396,190.010991524794,176.050187111064
"9808",492,85,407,188.77797879627,176.598855503902
"9809",478,82,396,194.864882843128,181.608397565314
"9810",487,86,401,197.982519731158,179.927421189334
"9811",494,85,409,186.428557539147,174.565981082447
"9812",492,84,408,202.297675762837,173.289236177366
"9813",480,91,389,203.9114495668,182.139094676311
"9814",487,85,402,184.892942249392,176.744146377794
"9815",486,79,407,193.46382353315,176.485903473338
"9816",473,88,385,203.616690391869,175.573463970119
"9817",473,85,388,205.386368864643,175.541305038375
"9818",500,92,408,187.258003346623,177.122504957593
"9819",487,88,399,199.252874479129,180.17585252571
"9820",490,94,396,189.812803452574,175.198040017173
"9821",478,84,394,199.246768219049,177.70686283763
"9822",477,86,391,207.458147933909,178.318595664879
"9823",482,85,397,201.06027682467,168.58509356134
"9824",483,90,393,193.527184988169,173.386768407684
"9825",469,82,387,213.905208839904,178.736652161176
"9826",461,76,385,194.032318750806,173.26276203172
"9827",480,87,393,185.501607045532,174.983697596301
"9828",478,81,397,190.767350758231,172.582025042136
"9829",477,82,395,196.125368451152,173.839156009446
"9830",485,85,400,187.399405107209,179.585784335911
"9831",482,82,400,191.581904745536,173.374551797955
"9832",474,91,383,182.716289635319,179.930872505146
"9833",492,91,401,187.425882391758,181.942972229718
"9834",480,83,397,206.169009161018,168.894576163682
"9835",486,85,401,196.115130170258,173.022363363694
"9836",491,80,411,200.302996738439,174.0516609351
"9837",476,85,391,199.152845864645,175.8285617827
"9838",481,78,403,208.050287814061,169.724270711994
"9839",483,92,391,199.39873545276,174.311456712531
"9840",474,76,398,186.546093343723,178.321568598114
"9841",489,83,406,193.658541776857,173.703870494931
"9842",493,82,411,191.254327965273,177.40646085467
"9843",486,84,402,207.727663711468,177.365255328059
"9844",488,88,400,189.471859638811,170.617424085325
"9845",494,86,408,193.333291891831,177.602106381896
"9846",485,78,407,203.786647626047,181.952228850769
"9847",484,88,396,188.699362356284,174.730325093893
"9848",483,93,390,202.669167420406,173.048931747818
"9849",476,90,386,190.684927393838,179.889713562839
"9850",495,90,405,203.728035246428,173.570894564304
"9851",502,86,416,199.445904602079,175.82179514251
"9852",471,78,393,186.326667061393,177.523047482223
"9853",482,91,391,196.7980076131,177.234763611766
"9854",466,83,383,193.602502991427,175.617877570783
"9855",489,84,405,194.173366399606,175.872046054243
"9856",476,91,385,190.745301838378,178.595209766573
"9857",498,89,409,195.272476211559,174.546907565596
"9858",489,87,402,188.155171781636,172.746639991148
"9859",472,82,390,208.278827896447,178.957078827529
"9860",473,80,393,194.486073733024,177.822442046588
"9861",491,88,403,192.488789450458,182.894104351924
"9862",485,86,399,185.575130620046,174.106662476435
"9863",491,82,409,202.114593572537,178.515319286812
"9864",481,86,395,193.220491075778,170.668659320717
"9865",480,91,389,200.863677702217,175.854907959178
"9866",500,92,408,199.339077077131,174.610422920021
"9867",480,87,393,216.858198644244,181.26877792978
"9868",480,87,393,184.347914338862,172.228147884531
"9869",474,86,388,198.018735432429,170.834535501373
"9870",485,88,397,191.448387039231,178.753171303744
"9871",480,88,392,186.999982975017,176.466039287559
"9872",489,77,412,191.72113118012,172.165872435455
"9873",497,83,414,184.387476309557,176.14476414045
"9874",479,83,396,197.637415376233,177.80462825857
"9875",486,86,400,189.104924709592,176.704593592273
"9876",461,82,379,199.527437880163,173.640489288402
"9877",489,84,405,191.855540275961,176.639404104855
"9878",472,91,381,170.242129349609,175.27942376692
"9879",483,92,391,183.809716267931,172.959362262695
"9880",490,79,411,189.208688659654,179.25840377629
"9881",480,92,388,194.25156774323,175.926640919303
"9882",484,81,403,194.289243747097,177.406512985019
"9883",486,88,398,174.030682884421,176.24168208989
"9884",476,79,397,191.769225943078,178.837867707538
"9885",489,95,394,184.698510025342,174.55056231775
"9886",488,90,398,191.187871956283,183.938802349286
"9887",503,96,407,196.007517024992,173.74242153869
"9888",491,86,405,195.711886199901,176.636757422916
"9889",477,85,392,183.870755078643,176.968436950322
"9890",482,84,398,200.598907157493,184.360356491358
"9891",468,86,382,199.145524821378,173.930307865002
"9892",484,79,405,199.453735411109,180.930189542221
"9893",490,87,403,191.9696239564,174.856701918265
"9894",484,84,400,199.621934962206,183.169164290349
"9895",483,91,392,186.342999552801,176.049160658065
"9896",499,79,420,201.354673407202,179.089819459447
"9897",486,91,395,188.030598714402,175.995567818909
"9898",475,90,385,205.636602122505,182.957111333474
"9899",470,84,386,188.330301021319,177.798039131539
"9900",486,86,400,198.957211147514,179.291443328359
"9901",488,92,396,190.842144741879,180.541081708336
"9902",476,82,394,193.788245966478,175.365383840493
"9903",485,86,399,194.078896401441,175.904396231492
"9904",484,80,404,198.737197612715,168.153394857109
"9905",491,88,403,190.831371985617,172.731338892338
"9906",477,90,387,199.601270049227,176.089881742774
"9907",501,84,417,192.991015231769,175.407134354464
"9908",487,84,403,193.333630232177,170.262274311181
"9909",469,83,386,200.520055503996,181.116855468929
"9910",486,86,400,196.950954363873,182.810500509801
"9911",493,91,402,181.61089415471,174.235889014585
"9912",470,79,391,191.269619239484,174.6331698677
"9913",496,88,408,194.02797646993,178.516019738258
"9914",506,92,414,200.00348064525,179.671453944737
"9915",491,88,403,188.442613327826,176.969790846235
"9916",484,88,396,189.575270631491,179.007230188911
"9917",483,88,395,184.688530224005,179.296748113798
"9918",482,85,397,204.434319467317,172.34458253768
"9919",477,87,390,194.350228838705,173.862924643238
"9920",463,82,381,186.299494627564,177.1810301177
"9921",495,90,405,188.708008089185,175.278189842294
"9922",476,90,386,190.777998202773,172.694042334674
"9923",475,85,390,206.573875934491,170.84478724923
"9924",476,80,396,198.291480380974,178.051277871548
"9925",485,84,401,195.036339288208,177.597221852819
"9926",488,80,408,187.473241162069,173.905311366131
"9927",479,83,396,195.338978841433,178.673011591123
"9928",489,90,399,175.379923438535,180.256363785259
"9929",490,89,401,195.488958337911,178.175138658269
"9930",497,90,407,185.699142256202,175.50064928848
"9931",496,89,407,198.48734688863,173.1557619344
"9932",473,86,387,206.234639997414,174.306146976048
"9933",497,96,401,198.495074281812,177.982919130156
"9934",488,79,409,183.346349477501,177.144769372649
"9935",476,80,396,200.639901389388,176.461073302796
"9936",486,89,397,207.876777249192,177.095861081496
"9937",492,92,400,199.219935836193,178.055096779868
"9938",496,82,414,181.002330682215,174.204106281383
"9939",472,90,382,211.100995090385,177.724482748711
"9940",499,95,404,192.709059890722,177.016109191349
"9941",483,84,399,201.976633759144,171.995647169908
"9942",463,79,384,196.305645862251,177.902216615991
"9943",495,90,405,195.496527852769,178.155725484382
"9944",480,79,401,205.787591932349,181.084705926576
"9945",486,85,401,182.185075444992,180.191204717259
"9946",489,89,400,201.767285629479,171.413179257987
"9947",476,87,389,208.756687643145,179.932937655803
"9948",486,89,397,203.46825240587,183.890453670657
"9949",506,85,421,179.386337000737,184.000060824421
"9950",472,84,388,204.324689213312,175.272425370631
"9951",491,86,405,201.845110198067,174.262105475439
"9952",478,86,392,207.132074421255,175.014151048956
"9953",485,81,404,182.284269703115,181.338918842693
"9954",471,81,390,191.607769612601,173.235320962091
"9955",497,94,403,193.278203315833,175.674235665732
"9956",506,85,421,200.997321829397,174.872667838663
"9957",486,80,406,204.548085782901,167.196538378861
"9958",497,88,409,186.352719854626,179.537755702115
"9959",501,96,405,195.886934214214,179.431571144533
"9960",487,77,410,204.824451741387,174.840782883069
"9961",474,81,393,198.877617579137,177.706222982581
"9962",482,79,403,198.155783913152,181.788281565632
"9963",492,85,407,185.420697281778,171.131623065313
"9964",495,95,400,208.660028453659,173.032346053175
"9965",484,78,406,206.862997512858,176.427223415315
"9966",477,84,393,189.774837119767,176.377838288326
"9967",473,84,389,203.607481851615,175.107305995653
"9968",479,77,402,204.562941667419,174.709250593846
"9969",491,83,408,191.472633686242,173.334197448019
"9970",486,81,405,201.097028145511,172.659820596258
"9971",485,80,405,199.17222047925,181.223184236553
"9972",478,80,398,193.076884142162,176.441818904786
"9973",469,90,379,196.854804467491,172.283805421988
"9974",482,86,396,191.83566557337,174.380459910694
"9975",479,93,386,182.078741711913,177.308491475699
"9976",489,87,402,186.570207960268,175.011088399485
"9977",482,84,398,183.283955176752,179.128164992098
"9978",481,87,394,194.83408729424,175.824755581015
"9979",487,88,399,210.855386638073,178.170777460787
"9980",492,90,402,189.732511482729,177.38877126339
"9981",475,86,389,197.673348577761,181.137825852596
"9982",470,89,381,197.93026459945,173.186443062845
"9983",490,88,402,212.383054165598,175.705360961175
"9984",471,79,392,190.30174272189,176.708155958493
"9985",488,87,401,183.668003573151,174.977708306663
"9986",473,88,385,202.708126579713,174.083902146345
"9987",497,85,412,208.389692050719,177.873845577362
"9988",476,82,394,189.209815430252,169.936997104666
"9989",494,97,397,195.288516147754,173.928474360817
"9990",477,80,397,193.804443326851,178.919536999031
"9991",488,80,408,194.446371895644,176.986937263006
"9992",480,77,403,192.044019235,179.497246983806
"9993",472,90,382,191.539698696736,179.716308334074
"9994",485,93,392,184.419797403267,171.777883038985
"9995",478,86,392,178.163837821285,174.342890122436
"9996",475,86,389,188.25310350988,181.045370729148
"9997",481,87,394,194.419484498146,175.194685146823
"9998",504,93,411,198.012042594237,174.530235669868
"9999",475,84,391,200.74925454244,173.291689569968
"10000",491,90,401,200.074022614757,184.199006690967
